she: uuc vrc mzr vtq hgj uod
wfv: vzt
eyh: gup
nxz: vxm rki dwl
qxo: yim mcl bcd puv bdc eiw meo
wwc: rbb wkj uqo iyc zbd ilj
foy: fbd exx dtw
dpi: nrl nbo rro gjx
wuc: ylg yfh ftd tpy lja qij deq zfd oeq
nlw: ogt rsw mfx ryc
uyd: nxa gos cds nci
xno: mhl yaw rvn mgm
hgj: exx mqa sxn ody she way jyc bnd thl ogt
cbt: qtk kpz pmc
srb: uzr ghn
idy: jha vtp bwe but pdc
cqn: euq
nsg: ove jzq nmf
ydi: efa oyw zba cgq ckb
hvm: kgx oxh qlv vgp guh obj
gim: odz qhz nue
dyr: mfr
lcq: xxt srp pnu erg
yme: pfy kzr nvq kqo hqw lgn ada
oso: kvf mod qyp izx qao
umf: jxh nvq bgb jyb zej ove jzq
rnu: ysi eim
zjg: xck aow vtl ehc qah
was: kfv rab olu dvf vuh kki srb
ejb: tga dpi fbv nmj bcu ufz
jmq: kob ycd
vxi: kki ciy feo rvr hox loy
rab: fmg uly
qln: jne fkv hki tuh
srr: ajs
qpv: uxq zws qpw see
khf: qec
nja: ojo bsb ivl vok ryy lin jrg
zdc: rsk rkq mpu gya yjk
jhg: gxo fsp jlt ilj jcz
ypo: oyw vgt gau pan uon gqo jig
qxj: jax fhn ufv nne jbb wdj mre
xst: fkl tgg wvh yvc hxa hrz bnp
zht: dbx dqy gci tlf rwt nbo kfc
gxf: kma
erg: lcq uoz vdh
snj: sam
yaw: jhn
ccc: cyz jao jjb
pbm: ksq rkq ojh sad vrp ivk
dut: zmd obh tcr
igw: caz jvz ezn pma lmz
pss: rke trf zgz spb cir dgz
wxq: bqz kks cyq
ipk: ypl izx
dli: xzw zwc wrk yxk wwy
ozi: hsa cnw kvf wur nso hxf mdg
cel: zhs jkr oqa
ryc: tqu nlw vib wny zpf
ehc: qzx ftb imc htx
mst: unk rvn npe bxh gzd
oqa: vxm
tff: nfu sol peh jpq
rhn: pmv oqm kww bbk qov vrl
rsk: zdc olj ozd tvb
aku: hrz suc
ejh: ngu yvc jbu iso jta cel vwi ozd
wyb: mie frk rnw gab nhj dhi
xss: jtg mqa zsp wqv ufz pmw xfm
lyl: ggo sfa csu
sny: vrc uqo slv ivk rvi zwc jyb zvy
xer: zzc fou jkr
ceu: nhx kac
nle: lnt mvv
rgx: hbk hqn goh pby
nwz: qzu ure tuy zgz
afl: hsa mdn mlk aws yml mcu epi oee
ene: qyn mus xxr
fed: ukd nva kbu lza oaz
cqw: edu wze ezh
wxa: igh qao vvs nzk psm xss
aut: lyl gfm yce uat ipf
tyu: nfu bgb tff odz uvc
geu: dgs irs ojh kou qzp hzg uxl ada uqo
jha: wdj qzx try jpe
eej: xlk dun anz jyc
xvv: jcz spe
vrd: icl spg
ikr: yjx fuq shn mmh pvh
aws: vki wkp
acx: puv
vld: hox mqq dns
znt: sfa ctg tfx hgu wzh edu slz exy ndi
lja: btb rsi iob pua
crh: uhu nlh mfp fhq
ibt: nxz sfq hvz goh ksh ptb ubz
wkz: dqk ueh
rbg: lwc uvi
oxa: stf rqt uij
zyo: buy qtv imc vqt khf
ifn: icj efa zel ryt
xgz: tyf dyo qph vch
dgs: zwc mxc gkb
uar: cnw pyx
eak: ebr ycm rjz
dns: jad rtq
nma: zel asf vpm bxf nod
hef: xhs ikf jhx csu zuo bsb
nbo: fkv zht hxf
nvq: weu
ois: pyf zlf
yce: fmg aut mpx qzu iqd
jgw: ssd tau ufv
foe: mxg hwe hzg
mfr: tso yxg dyr
kbz: izs
ofw: ypt ejq ynt hbk
gfz: myt kqv ich rtq
rlk: nxw pyf pgn
xli: djh sad ymi
uxl: geu zvy
izx: rwu ett ipk
eqz: fqu eaw zsf
mie: iqd ptl vmg wyb
czk: mnr mlj mst foc
loy: vxi bfk ywi
gkb: bnd
pts: odz mji fhk vch tes ckh ejq
nso: ypl ozi wfq uvx gzo
azv: tsn xlj upf uyd ebn puj wci idn ymo
ofc: lqr nbs cda wau rmz
lqw: xax qah dcu uos mnr gzd jtx thz
utu: ezh
wdr: ela mqa
aow: ezn zeg qyv zjg
ywk: tyf gbs ysk eca iwd rwt
ktp: xtr ykd jpm fyh uxl hqm
hbk: lwc rgx
tso: nfm hkm sor mfr
gwg: jmg omz tyu whj grs nso zdm
pdr: ccb oas mqp zel wze jig yjx tdy asf ifn feo
qhs: kzv qtk cda
rct: wxs ats zuf cgx yaw
icx: svc dtr bpf
jxh: kzf
fbd: rnu wmi uzy foy ipt
oyb: kuz ojo mnd wka rjz
fom: upf jsw mcu
zej: lot rae
wzh: znt sor yof vpg pvy
fos: kgx lnt ycd kml jpq
hpr: wvh ybz zxb
xax: tpk yqg
kdz: glz lhw vmj
qdn: sbf khf mhl kqs pot nyt ppm spk kqv lda hkm niz rfg
upf: nmj tay jnv fom yen wdr
qao: hwp nzk oso tvb hst hzg bnp wxa nqw tcr zag
stj: jao fod
vhm: rct jrg kxk oav
xfm: way tyf
fty: mww ndi dyr
jbt: ftl cgw
pgd: qov qtv veb
ipf: aut
bag: omz
rtq: jhy dns aha
iaf: sie ofw aqn gfi
frh: hox kac iyr qzu flx
zrt: fmf qyp kdz meo lzy
aos: btb spw ebd lti cyb
yte: mgm
xsv: ygt
ctg: tpk xts vsw sgy xnu mgm ygo rwm
zeg: amt wdw qgt iou iwt
sam: guj hxa snj qph szl xli
hrz: uzk foe aku qhs xst
cms: xii iwt uxc jiy gtb xee rbu yis
olj: tyf rsk vff nho
ubz: mps ibt
eur: oyw clt wqy
fkp: aeh nrl mtz lvn pps
nsa: lhw ird xrg ggn
rgq: tvb
fzo: hty agx cur srs hwp
xlk: qbp pww
vsg: dgw cqj xpn vnd
eks: exz ody hki
dkz: mym fyi amt shn
quv: ggo qij
ent: luy xya xfk qht
ckh: xfk bqz gim zmp hex hrj sfj dwl vwi
peh: qpd ooc jmh tff hue cpz
klw: lqr bdc qhs fcg mps
jnx: ysi bgm
yqp: kxk yaj fak tjt ige eoh
tdc: udo zgz iwt tdy
xii: cms kpq tvz
xeq: vsw vcu
mdn: afl uod
ftb: uij lmt
nmy: mmh jyd
ewp: mfi wyy tyf
wrd: cfq kfc imh bpi
sca: dfk lgn mtw muf zhv lla kso fel ynt wkp scd
rvr: mej ftb vuh deq ure vok jax vxi
rpo: yqf lty rxm qrw vhm dud ptk
ttw: ygi pcl rzn jhy
iou: ppu
ead: kwu bww nod ilp rgy ngt mil
wqs: heo nxm psx
aon: vuh mdj ocu qyv fuo
hds: uff
pxv: xks zdm hwq jbu bbi
bmh: iaf snl vlv wur vvs ozd jjx abi
xmz: ilj idn yql fye thl nlw gkb sly kfc
gci: lot zht
vqg: grq rea lda ene
mil: rjk gfo slz ycm
jpm: ukr uyh raf
uuz: xno uon mdj tpk dpo bdw
yqg: gnx pgn kyv mil jpe pot zvj ndx xax mqq
kby: qer
rqj: hwp ezk
rzz: zln abt imp
tnd: zag slv tit irw djh ebn bqz
qzu: qwz frh nwz fst
buy: nds zyo lfb
ybg: dwf lmz pvh pcl ndi pjj gfg gau fkj prt
xks: oly jcp
ocy: bpf vlb vvs qfw fvz pfy dwe
gbs: ykd
nlr: zdm rkq pid lfe ody rgq aku vfk
hvy: spg
pxh: bbi dpi wtk rbg
rxy: ctm fsp vgp wrk sdt xja zhv slv
kou: fkv epx yen kzv wnr eqc
oaz: fed gzo vpd yql oly
mpm: oxa yha
gdv: qlo oav irr
fkv: gtg kou nbo eaw qln iyn bbm ubp zxk
mam: bji
adf: wti aak yja
wzx: mws thl
mqp: uos kjt wqa pdr vkj wka
jva: siw ljx ezh
muq: aux kbz axp caz mrf ily sgy
pan: brl ypo ium iic
unk: bji ygo jbb mzf
hnn: qmb zzc
uff: ssd ygo yjx lbs pot rrm hds cou zws
jjb: pua dwf jyd ccc vxp
dkr: mtl avq pvh wpf
ndx: ssd jrg mtv yqg ngd waa aix
bww: rqt ghb ead ubk
tfh: rae zmp tit sxn mxg tjr prg
cqm: mbz
yrz: alb vzt
qrw: wfv dby gme
vqt: zyo nrv wqs siv upd
oxe: rzn ydi lin cxz wvu asg
elm: zse dvf
goh: taa rgx puj lnt
iyr: vtp ily ryt
ogw: mgf
sed: vpm zah qfy dfi jrs szf fst fhn
vgm: uqo lte hrj mws pfe rps
dfk: sca fbd nle xpr yzf nso
yuu: kjg gkb ybz hki
kes: yln uwo
zxz: lts tes icl
kwa: ich bsb hjx nxw
ghf: luy dus jpq mfx umx vrs ogt
ich: mpx srr ktu gzk zuf gfz alb kwa vhg
udl: ahy ehy uzi sxn eca iii
iic: pan nds
kzv: rwt qhs yax ufz lte
vib: ett irw zdm
mlc: xac xeu abv
vok: hse ocu sma
jmh: fyh ljh ihb peh
jta: qvi vkn ejh
bcd: qxo gfi mps vql
khu: sie hwq jsw meo zej nvq ejj bbi bcu
tsn: not ebq azv hdt rgq
aff: jpq dbx uoz zxb hqn ebq
wxw: nyq ptl
zdl: zyv geq xjx vgn
uip: wul but wzs
idn: vgp tzc kks gpj lpk dqy
pfy: zdc zxk mlk yme avo
ihb: myn
vgt: dpo ypo
rxb: dyr ozq dgz
eca: sol ezk jyb
yha: yxg uly sbb tub mpm kke wvu
yja: beg
guh: hvm srs tcr
frk: mil sor spw xpw cra wyb
ybz: xya
ahj: svc ghf wrk vkk vtq taa
kab: bsf kjt prj kes scn drh
wcn: wfv oig vvp dxb geq
ild: hwl pyf sgy
ooc: peh nlw ieb hvz tgd dym
cqc: vqa wqv zmo pdo cny epx rgm
mus: qub ckb
blh: obh bnp
ejn: gde suc jys fvz gim vfk vql
uxr: lte lot uod
wzi: eqp ufz zag tcy qfw lpk mgf xxt qje
uvc: dwe tyu
not: yxk vgs ysk mfi tsn hki
xlz: niz mnr qqp eur oie fgx msi
nqw: wmi dut yml ada ypt sly rqj qao
vrv: pie tct ghn tly vhg sma ujs
tcr: qzj qao dut zor rbb
hqg: jiy xbd yqs ext qql yrz
uwo: kes ggo ycm
pbk: uji vjz wxr xby hrz oly nlr
xxt: ody ccn wzi xtj
lmt: ygt jig
jtg: kyq
kma: jxk whj gxf uqo
uhu: ubk uwo kke mus crh
vrp: pbm qfw nrl tcr owz eqz hqm jbg ija
yik: mcl ayn ird
wde: vwi nue pis
clt: kyc slz dws
fmk: pmv snx yyw pma kpg
ozd: rsk gjx
jzq: mtc nsg
rkz: nho oxm gci ztp hki wxr avo ibp
vch: taa prw
wjs: omz hst ykd fhk dun ubz
eqp: dym
nlf: bmt fje wze mfr rwm deb mrf tau
tuh: dtw acx vpd hco
dpo: yxg kxk vgt asg psx ttw
boo: ylg nid kqs avf kjm
pwq: uap lnt
mqi: icj pqk gpn utu
tee: iju ckc try
irs: yql dtw zmd puv
bsf: kab gfg hjx qrx jax rtq dty fcj
wfq: obh eim
bdc: icl tqk cis
qpw: cpb oeq qpv
kzr: ezk vwt rkq nci yik yme
mtl: eis aby axp pjj dkr eow ood han dgz ing
pgn: uos mww bfk fnd xgj fuo yqg ats rlk
prt: ybg gfz qqj snx
fye: zyg pyx
aak: adf rkr tec loy jmu mgt
ett: die izx vib iuo mfi esy
axp: muq rzn uij wyb cjc
xqo: heo pyf fkj vtp
owz: ixc wro
tfx: dhi qsi
opc: iwd ymo alt
fce: wwn yim btx jcp wci xrg fqu sta
bmt: ftb ptk oig gqo nlf rkr wxw
jbb: qxj qqj fnd niz abt unk tvz psx
mdj: mcc kyf otx cyz uuz yrz aon
qmb: hvz rwu igh ebq guh mgf hnn tce mcl eyh
fxm: han
iae: zse zuf ejp
tjt: wqa yqp oav ryt rbu rvn
lyj: rea rnw voj iik kez
grs: vlv qzp wmi mqa nzt wzx vtq
ljh: jmh whj
gzk: mym fnd
zxb: amo zjz hpr
vff: qer
jlt: dwl oye bbj jhg xgz imx mcu
mnd: oyb bww sin rvn
frn: wmz
scn: thk tfj qyu dgz
zpf: uxn whj
gqy: htx csu qtg vxy heo
wdj: jha fyg oty jai urt
duj: ads zsq prw xks
dtr: vgp mbk wxr
jbu: gim zmp ehl kmi pxv pfy
hgu: mda znt iqy pvy
spd: rgy vqg oau pmv uka nhx
amt: lin zeg srr rgw dkz
ajh: efy axh izs pua xck gtb nmy khd fuq xnu
xtr: vqx mmy
dwl: jlt nxz
wtg: lrw mbz wfv kpx lyl ydh
deq: wuc tau cra wpf
ijk: ftq ads zwq vsg ypl
fou: wyw uxn xer xby avi
qai: qgt bxl mnr
kbq: hht jxb cny vqx
euq: eis pss cqn jrs
yql: oaz tzc pvm jpq
hht: dqy wjs kbq pmw
fna: ylg tvn rkr
sdg: ucm ukd
aye: loy zkf lif iyk bxf kya dby lmv
pfe: vgm
vsw: imc ing xeq rlk max loy
bxd: hue acx cyq ksq
zgz: nuj spk pss nwz
ylg: fna ily xqo mcc boo wuc
rre: ufv srr kyv qsi qij mlj
wxs: gkt bbk iae bxh uhu rct
lla: sca vua uxt wde
mfi: ewp wwy ann czs snl not sdg
xaj: bar uka kuz elz kdb zsv
siw: eis jva
htx: ehc oyw krz
ndi: nid dsa
zpc: nod elz xac edu ikf soj
ove: ydp nsg ptb
esq: ivk
fmr: cbj zfe gtb mzf pul mgt tma ppw
rrm: kyf tdy
pww: fel xlk eic vlb nzt nyy
beg: zyo xhs ftd nds yja rsi svd
kob: kso jmq vfk hzg kbu uod ljh
ydh: dwc zuo gkl nid
pjj: aug
lti: kac aix vfh aos rsi ocm kiz dky wdv
mnr: dfi czk xlz lqw
vjz: mnq ptb kyf
dqy: hht gfi idn
pyx: nqq uar
dbn: ezn ndb rbu xhs jrg
zdm: vib gwg nlr
odm: psp
bwl: hpr gxo ukd
grz: zlf qlo vpb odm chl
gab: dxb jao zse wyb zws siw lmz mie dgz
pma: vvp wka mgm abt kjm
tkl: enk wci mps yzx phj
rfg: thz mbz qdn
mvr: tpk jwh drk tuy ozq jao yvr
nrv: elz mfp vok jmu
pnu: lcq rsk mbk zmo myn kml
rft: cuf bwe ryt yaj
zfd: kki mrx
tut: gdv kyf
vhg: fmg xau vlj vrv mmh bww iub
atq: gdf oxa
szf: kdb yyw
ftq: xmm sdg btq scd
rmf: jmu nds yvr oyw
juv: kfv inm qtg ebd gdf elm
vqa: nlr sfj cqc mlv ptb bpf ikj nzt naa jys
rro: esy idt noc fkl wlk
ygi: lfb vcx ttw pma pan ebd ojj kya gkl wnd
btb: stc aux lja ngd ocm aos mbz csu
puv: fyh lcq acx irs jpq
ood: voh icj ois zdo
avo: pfy hty sam vua djh kzf kdz cqj kpz hdt rkz
nfm: mam yaj xeq bbk tso imc esz rzz
wqv: ywo cqc vib iwd
jbs: nqq wlk qer qaz wvh zsp
dro: zfe
rea: fkj vqg qtv iwt
fcg: esy oye
shn: dkz
xpw: frk shn
vtq: grs ahj
gtb: fmr fej cms skf
rwm: gmk vgn ckc
ufv: dsa rre qxj
ngt: ead yln ene
axh: ycm vcu vrl pqk
tie: tqb xwv qyn
yen: thl vgs upf cdl
yml: tit gaf
yof: wqy jep
ebq: tsn tvk qmb uxr kpz
mgt: cir qqp eow
fhn: sed sbj kkb
gaf: shr vyl yml jxk hqm zwq owz
ivk: hey esq lhw
qaz: omz jbs bbi ykd nlw
urt: pyf dks
qov: rkr oeq pgd imp rhn aat jhp
wdz: kab crj jrg xjx
sxj: qub
jiy: hqg dhf jep
tzc: rpu gjx zew ksq pps
crn: vki sae ymo fmf
kyf: rrm jva cjc tut qfy vjz mdj
oou: uyd vwt ucm pbk czs odz djj
zsq: jot gya jyc duj ybz nfu tlf
vgf: jtx aby xii mrx qqp ksa
icj: qyv ifn
nwp: prw vgs xks zpi xjw
drk: csj ild yis kki nuj
dty: fje waa
kpg: zel
nue: gud ukr vfk wde uuc acs gim ilj
kks: wxq unq hdt idn
eqc: pwq ypt wdr wyt xby cis wwy
cmj: hqm
hxa: gfi nva
zgw: ebr aix svs fej tct
vxm: czs wur wmz oqa xjw
rbu: ksa dbn cms
sdi: vdh rbg nqq iii vwt fou mtz
wwy: dli gud qwz
pmc: cda wci rrh zxz
qyv: aow icj dks aon kez
noc: avi nbs zwc kbu rro
dvf: jbt zeg yvr vld sbg cxz was elm
nyq: jvz wxw xeq xpw
amo: jcz fkf zvy dzt ela qtk zxb
zpi: irv
kuz: xnu
irv: tdq
khq: kiz
jmg: cvc cur gwg ivt nle cwl sfq wlk
loi: pps zew czs irv uji kvf aeh fhk
kpz: ebq snl cmj
qbp: qje xlk wyw jkr krk bxb
wwn: zwq uap
imp: qov sin rzz
naa: xmc ory vlv xlk qpd jxb ffa
obh: tcr jcz nqq blh sae kso dut wfq rqj
pie: vrv qrq xjx rft sbj fki
mgf: ywk whj ogw fom srs
pqk: hdx cuf
uvx: acx lte tkl
btp: kgx bgm zdm
knq: daz ygt cpb rab qqp srl
wkp: aws wgd pis yql kks sca
cha: ssd prj nod zlf
xxg: sdt azv rqj loi bnz qhs gjx ydp zjz vnd
wnr: hqw dwl yzx shr
ywi: mlc lfb ykp ojo gqy wdz sgy uuz loy jiy
qrx: jtx iyr bsf gay gpn sgy
nho: olj uvj ljh oqa nsg rkz
vtl: fcj gzm ygo lrw zfe
gos: cfq zxk nsg hvy
fpq: dxb imc kes dyh asf mrx
mal: yvr ats tpy stc kfv fxm
jbg: sad vrp vqx
vuh: was aon trf ckc waa ivl izs
lqr: bme tvb nbs klw duj ogr abi ofc wlk
foc: eis rgw xts czk
prw: vch phj nwp
uod: uxr zyg vwi cjt ehl mdn
vki: foe crn
szl: zmo
kbt: lte snj jne esq oxh
jgk: bfs cnw hex rpu
vnc: jnv ukd exz jkr
dcu: lqw gsn tie dky
gmk: dwf qzr ftl rwm dwc
bnd: wkj tgd ayn hgj gkb tui udl
yim: fce jnb qxo zqj
yzn: zbd blh vyl bwl ovt pmw
jpe: vpg odm
vgs: mkb wmz
uvj: nho sfq wzx tqk hst gci kjg
dub: mqa zew wkj
lhz: mpx czk lqp yqs qzr vtf
tlf: zsq pwq rrh jtg
yjx: ojo pdr zsv ikr bxl uff
zmo: xlj pvm xst ksh cqc fuw alt pwc uji szl hrz pnu wrk bny vql
tce: nxr zpf pvm
wgq: uex
cmx: tly ycm gnx vpm egg
vpd: fof oaz guj hsa tuh jzq
lvn: fkp wqv vjt
cxz: oxe khq
xww: gwy sae nci pmc nxr mfx zhs
tui: alt iso bnd
niw: wvm skf qql csj
vpm: bio see cra lmt sed nma ebc qtv cmx
vjw: qyf pvy fmg xac pma cbj yja jgw ueh kyv avz
ahy: ehl ogw udl
tvk: yax tcy ffa yuu nnq ehl ebq irv
hem: zns mrx sbj gsn
ycd: xpn pfe jmq qlv jtg bph
ajs: mhl
ydp: oee ove ebn
fkl: rro
cyb: sbf tej vzz ppw npe aos atq
zwq: qux gaf ovt dub wwn aky ynt
ciy: ikf srr bwe spd
ayc: sbf xax ium ats
qht: dbx ent ipt doy zqj xlj vwi zor
fhq: stf
ann: qer etx ipt cmj lhw
fmf: tzh zrt crn fkf rsw jnv
ole: xya jug eic atr nho ieb nbo
abt: qfy pma
ysi: jnx rnu
mrx: fpq oeq
edu: zpc rkr ndb ksa cqw trf
dji: jnx ubp xgq rrh lgn rnu qzj
hwp: lwc fzo fof rqj gzs
olu: uuz tuy opp wpf dks crh dhf gzm
dtw: irs oxm idt acs tuh foy enk
uxt: lla ebq zjz ynt sad
xtj: ilj lot nbs ccn
fej: cgw gtb qlo
hco: tuh nsg
cnv: voh ftd jvz koy vjw bji qyv
qyp: ceb qfq
ebn: wny jjx ydp xgq vrd iam mxc
vdh: sdi vkn ihb uqr erg mcu uvi
kbu: suc kob yzx fed
thl: xmz wzx bbj rnu yen hgj
tgd: bnd mmy kyq rwr
voj: rke lip hds nyq
tgg: xja xst pty
mji: eic wnh gbs xtk
nva: hxa
cbj: aby
qij: ojo
jig: nhx ypo wka lmt
iuo: luy cnz rfj vch
iqy: ryy hgu xsv atq ium
dye: qtv fhr pdc ene
vlb: glz bns jta vff
ikj: uzk dun oxm hvz
sin: mnd qrx xjx lmz imp boo qgt ats ilp
znd: kke kkb sma zfe xts tjp czk
spg: bpi gde atr itb hle vrd hvy
siv: ido aha yjx jva ljx gzm vqt vfh wdw
boy: gde kmi wzi jzq atr
dsa: tvn ndi gfz ilp gfg ufv fuo ghn
ryy: nja fki act
zqy: prz wvm imp yln
gtg: aeh uvx nxz zew fkv mtw
rom: uat
spe: xvv kzf bfs
csj: stc drk
tuy: qyf lty nwz dxb
shr: muf gaf
yzx: nrl mpu tkl kbu
cwl: mdg zvy ypt
oop: jyd vcx cgq kqv pwv sxj nhj stj
fbv: ceb
phj: ory hnn aui tkl
vyl: fof kby phj
epi: ied zpf hvz bfs
bio: heo ang mcc jhj oig
cis: tdq oxm vrc eqc bdc bnp xzw
xja: rxy pfe tgg
xlj: qht ykd azv lzi dun
dym: eim jpq ymo alt eqp vsg
czs: xya vxm mfi
pdo: ywo zsp cqc jnv foy hxf aqw ovt
xeu: qol dby gau mlc myt asg
wny: hqn ebn
cur: jmg pwc hxf tkl
nbs: ofc mcl lqr
fst: gau wxw bfk
qzr: yfh
rkq: zdc way
tqb: vjy waa pot tie
ckb: vpb mus ydi ujp tdy cjc uij
ynt: uxt
uvi: rbg
dyh: mpm ckc dky vyr jbb gfo vgf
ikf: cqm sgy ciy nlf
mvv: ztp ziy nle rgm ksh jbg gud hue qxo
iyc: ekr wwc pfe ija
zel: vtf kpg
lwc: hwp hbk bvc vmj vwt eim opz vjz enk xvv rbg
sfq: jmg
oxm: rkz cis kqo
xwv: tie ivl fhr rab
aan: dgw ctm sae cqj guh exx owz
nrl: xpr vrp dpi nlr eej fkp yzx pid
tdq: zyg mlk irv cis dgs luy wwy
gdf: ebd kww srb
snl: bmh ynt kpz eic ett ksq mfi qil qzp
yln: ngt mda kes
jep: prt dws yof lrw
mdg: ozi xzw xpr hwe pvm cwl
jrs: yqf pwv
ads: kso cpz bwl doy duj nnq
jvz: fak nyq cnv rrb
aux: nma bfh cmx mgt vhg btb kpx muq iyr iou xts
zkf: aye ktu ozq ure tqb kiz fak bxl vgf vfh
rfj: bgm mxg ixy glz iuo xmc ejn yml
tyf: mzy olj ywk xfm xgz
shx: jgw wvm ygl han qpw vpb wvu tub aby irr grz oav
daz: knq tec tvz
ccn: pid shu
hnx: zqo ceu tub
udo: zln tdc uij nnt aby eoh
grq: ujs yyw ebc zns wxw wqs vqg kbz
tjr: sie uxl hvy opz ryc xby
crj: fyi wzs aby wdz tvn
vlv: thl fkf naa kfc iuo grs tqk
cuf: rrm vpb rft pqk gqo zgw qql tfx rrb
fki: dks fkb pie
ppu: gkl iou kdb qij nod iqd
xgj: cnz pgn mfp ryt
hse: xmw act zrk vok iou pvy
egg: ocu dkz mlj vxp tpk
mmh: vhg dhf nmy lmv ikr zba rxb lty
uxq: kuz qpv hef cuf vsw wul otx
ukr: qhz jpm zag qzj vbr
kkb: ylo qql
gzo: nso wyt zsw pxh wgd
rke: tso hqf zij xsv pss oav ptl
gkl: ppu
ilj: xmz nue wqv xtj ggn jhg
fuw: rgq sol ekr vua hki cbt zmo
oee: afl mdn yjk ydp hqm kqo
rjl: hqn rgq bnp vvn
srs: fzo guh
fkj: xqo yfh
try: ujp fhr nmv dgz ftd
aeh: loi jmq vki ogr enq fkp vyl tij gtg
ftl: jbt iic whf
ptk: gme uzr nhx
iob: mrx lja jtx xsv ygi vxy
pul: bpj cjc iou dye
gme: ptk gah ftd qrw
tvb: jxh rgq wvh
kwu: noh oer ajs
zns: fuq tut hem tpk
ymo: ziy vin crn dym opc
alb: exy yrz lbs gah nxm
wrk: ifa ahj rxy xmc dli snj yjk gxf
ykp: ujs rzn
zsw: psr wci bcu
dby: qrw dwc fzr
bpi: spg lnt qtk btq yry
vrc: cis sny
nuj: xno zgz rrb aix drk cou rhn
srp: ejj djj hwe
oiw: irw bgb way cny uvi imh
qwz: nfa wwy
ghb: ojj bar bww uhu uka tdc
zse: gab sor qzx iae elm srr
kke: yha mym ure
ogr: lqr cvc xja rpu frn uqe uar qlv
nzt: grs vqa
aha: kiz fzr ngd ygt
guj: sam idt meo xtk
mbk: dwe
ksa: wul vgf
xih: cxs hsa pfe iii zsp
kml: ckt
spw: kyc frk aos
rwr: nmf geu ymo boy wxa lqr umf
mod: oso
drh: sbg kab kez wpf lyj khq mxq wtg kqs
ehl: tvk gxo tkl ahy
nxr: ied ada asv tce bbm
zwc: dgs imx
bfk: dud fst zah loy pgn
yvr: mal rmf qtg cpb abv ium
csu: btb mpm hef
sxn: qtk udl
kjm: boo oie ang nod
eis: mtl zsv ige inm siw euq foc
prz: niw dro wqy prt zqy
mqa: grs wdr
sql: cpn wul jpe rkr ssd qpv gkt
hqn: aff aky wny rjl mfx
wur: bmh aqn ozi
cou: vpb but
jnv: pdo vnc upf
snx: fmk heg
tay: ovt eca vin xjw uqr uvc
gzs: ypt umx hwp ifa nmj hqw kqo anz yjk zqj ywo vff
ejj: ksq srp uvc wfq sny
zvj: sbf yqg dty rvn
tfj: xii rwm gfz rjz scn
jcz: nen xvv hqm jhg jcp
vqr: gbs jcz yjk fyh
ypl: ipk
hnc: hjx tej
jys: vrc phh ove iam uap
tga: ejb btx ent
krk: pis ffa rnu ryc enk iii sly
myt: gay qrx von jad gfz sbg
sae: aan xww
svs: lrw hdx zgw wdw
puj: lpk gpj azv jnb btq
bfh: deq yaj xsv wdw
fqu: vqx hvz nxz asv cds ewp eqz ixc btx vkk
xnu: soj eoh ajh kuz fty
bnz: qph
otx: hwl
max: vsw
ozq: vgn xph zkf vjy
qgt: kpg qub zeg rmf fuo qai xnu
sor: aix frk wzh
kyq: gfi nfa taa
fcj: oyw vtl jbb
uqo: sny iwd kma rqj
qzj: wgd bnp eqp tcr
hjx: bsf gah nyq lbs kwa oig hnc
qma: agx iaf gde cyq crn rwu
hvz: ibt vbr
jrg: zrk kky vhm ndx eur
sly: krk ngu
npe: ppm whf
wnh: luk bxd gim
yis: whr xdz fhn cms
bny: zmo jne ird sam zew esq
gnx: aat fod cmx yqg utu
oau: spd zws qyf yte qyu fnd
yaj: bfh stj mlc yqp dhi
kyc: clt spw yrz
pft: qqp hkm chl rom niz
vkj: tie tct cra
agb: aix adf rrb spk
whf: npe ftl
tec: lif daz but
vpg: mda oty wzh jpe wyb
vtf: dud jhy jhn zel
koy: sbf lip cnv psp
ujs: grq zyv ykp uka
thz: urt rfg
cpb: rqt tej jgw yqs qpw knq khd yvr
pps: sdt rki fkp loi bcu fbv whj xlg ocy wwc tzc
cda: pmc qhs sny crn
umx: gzs zsp ghf iyc not
trf: vuh irr
zbd: wwc
vql: cpz qhz ejn bcd rbg
yqf: bgg jrs
hqw: die eiw wnr ipk asv
oie: qyf xlz kky kjm
qub: qgt mus sxj
dwe: ocy uvc mbk zzc
kqs: qdn rhn fkb lyj boo drh jai qub han
kzf: kso zhs spe xst jxh sfq ilj ory
dzt: omz tsn prg fvz zmp pid ibt puv
zah: egg kpq khf sed bfk xau vvp
yvc: ejh
rrh: tsk ozd tlf
jxk: ija qvi ljh qtr gaf exx kma
qvi: lzi hwq vkn jta
bdw: uuz kyf thz vrl
mtv: ceu uip rvr aat iju
kez: qyv qqj
sfa: znt shn wvu
sad: xli jbg jnx qlv uxt kjg zxb
dbx: jot wnh ggn zht wwc qht
ebr: lip eak ywi pwu vtp cou bfh zgw
olg: qux xer tzc wmz
jjx: suc
xlg: hbk rfi kml ayn itb oxh
qol: xeu hox kpx axh tcb wzs cgq
eic: ole pww mji
opp: pdc olu cpn lrw mrf
chl: grz zdo rbu
ehy: xya tes udl zxb
qyn: wzw ilp
qql: cuf kkb svd jhx mxq
oty: qsi vpg efa upd
wau: pcv vnd ofc
dus: yry ynt ghf ewp lza dtw vmj
vmj: cur lwc vkk kdz rjl vin ipt zdc
yyw: niz fmk thz cqw
bxf: wzs bio sma frh xee nma
vgn: rxm rwm gkt
asg: dws kuz
ukd: sdg cyq
fgx: ing siw rxm zvj lty zfd
djj: oou opz srp yoo bph ivt zor
cwr: psp nxw dty cgw
dhf: jiy wkz kft kfv
uuc: scd cbt jyb pcv
nmv: xdz rsi try imp kez gzd nuj bsf
lcv: kyv ipf knq spb fyi cqm
ksq: ejj abi
yxk: ann rfi nxr tff not iso dli ngu
jsw: fom qlv
kfv: mal was
lin: rsi amt
slz: nnt clt
upd: oty stc uwc deq xbd
bbi: pxv qaz khu
qux: wur psr nxa aui olg icl dun zwq jtg bme gpj
uly: rab uat iou
zln: bfk gsn ium cxz max rzz hdx udo
hle: spg cnz
fel: ybz zmd cel sam pww
yhq: imh odp djj nui gfi vxm jyc bwl
vvp: xee wcn dnl eis qah pma jep
lzy: qtr pou zrt mlv
ilp: jax qyn
ywo: vin pdo jhg jsw ovt wqv
ojj: kya gkt cbj
yry: mod ekr bnz bpi ubp dus anz
ext: hqg gdv htx
jne: zmp qln
vmg: xee whr uat mie
btq: gwy jcp puj bpi rxq
bcu: pps psm
nne: mda ubf von qxj
mtc: jzq bxd dqy hsa mkb jcz epx jsw
ezk: rqj qil acs
hzg: qao
vgp: vxm idn hvm dtr ogt yoo
sta: nqq fce jne qhz xjw jyb
dwf: jjb ebd qyu lrw kky gmk
wxr: bqz opc cbt dtr
nci: pwq tjr svc kzr uyd eic
xmc: naa wro uqr ija
ing: fgx vsw rhn oyb pvh nne zkf
kjt: tdy eoh mqp ocm pka
pou: zor lzy mnq izx
ivt: djj ydp
elz: mnr nrv dns qkj
hkm: htx rgy hds tso fna
zsv: eis qec
svc: icx sxn dji cnw vjt nci ahj ory ahy uzy
jao: mvr gab utu
han: mil mtl gay fxm ygl
dun: eej ikj
svd: beg ptk vgt oqm qql oav mja rcs
gfi: iaf kyq hxa dqy
vzz: wnd
fje: wul dty gzk oeq
xfk: mfx ckh
lnt: nle goh bpi pwq fos
srl: jhy brl uzr
imh: wrd cxs ezk cda yhq mdn etx idt rae
ied: aky bbi epi ivt hty nxr
sqh: jot xgq iam die oou jjx olj wtk
gwy: mlk qwz gya lzo dpi btq rwt wro snj xtk xww uap kpz
htq: ocm nhj fxm hwl iqd vzz gpn
tly: cpn vrv tut dkr rjz rgw
pwu: yja khq ipf abv spk jvz udo ebr
zmd: fel irs weu
zor: tzh djj tcr
ats: zfd rct zyv
xzw: dli alt
ftd: cnv gme
skf: niw zpc gtb lhz psp vgn grq atq vcx jvz nhx ocu qzr
oas: mhl mzf abv agb ndb ats
zag: aky oqa sdy tnd
irr: trf zdo gdv
xck: lfb quv kni sbb ajh
fak: jvz vxp kkb fyg
oig: wcn bio
nfu: yax tff
zvy: sny bgm
mrf: muq opp
kky: koy qtg oie lin jrg eak oeq noh dwf
kpx: zrk
bbj: zxk tsk jlt
obj: frn ieb hco itb hvm btp unq kbu cjt hue
zsf: zsw bbj nfa bag tcy cds eqz
wyw: fou fye iso qul wgq
cgw: rea cwr kez jbt kki qpv elm ure fej
sbj: pgd efy xxr hem fhn dws
stc: brl mal kft upd btb csj
uka: fmg ujs
gde: tit uvx wgq ejn
hdx: xui ige pqk svs
qfw: tay wzi exz qwz
mcu: fom tij
raf: lzo hex jpm nzt
tct: vkj euq qyu zgw uip
mzr: mws nyy bph
qrj: zdl qub shx gah qtg jrs esz bxf
bpf: vvs icx puj kmi ocy xlk uxr prw
aug: kuz iic yof bgg qrq kft otx pjj bxl
ngd: ndx aha
dks: fki max urt rqt kyc qyv
gsn: jai zln uos yrz
fyi: lcv qzr dkz crj ktu
bxl: zkf ygt yjx
gzm: siv vyr olu
pka: cqn pyf qrx nxm tpy kjt
hki: not eks abw
nxm: tau ppw
bgb: rsw hny oiw
gfg: feo jhy bsf wpf max
jnb: aff puj yim zpi bcd
act: xhs
cra: vpm deq avf ois vkj jao
uex: xli wgq ihb izx
ccb: fzr hqf
wka: qlo pma bxl jig fhq
xpr: mdg ubz tce hue aws
wvu: yha
esy: pwc rro acx ett fcg bnz nmj
jot: cmj sqh
jhn: yaw chl uly hse vtf iqy
cgq: zyv szf kke ydi
bbm: wci imx vvn nxr qvi
flx: khq gfm stc nax pab frh aye
lmv: aye iyk qai pvh
iik: xii ido lyj frk wze fuq
xbd: jwh gme
exy: znt dyr
rpu: aws fcg dwl oqa tzc jgk
anz: xzw zvy bgm
wnd: wvm dyr vzz qsi fki
ykd: jcp xli qfw hsa xlj gbs
vrl: uij bdw
pvm: ucm yql dgs vtq tce ehy bag rgq zmo xlk mdg
cpn: geq juv vxi fmr sfa aye sql xhs bgg tly dye jha opp
zdo: jai xax ngt irr
zlf: iyk mww lfb rrb grz ois
zxn: cnz kml lgn pbk vrs vpd
fmg: rgy vjw uka vhg ocm rab yce
hxf: pdo klw rgx nbo
efy: ajh spb sbj ojo vzt
avf: boo cra voh ojj crh
qsi: oty
ixc: fqu prw owz vvs fyh
nnq: tvk rwt pid
iwd: opc
rgy: noh hkm rfg ium
kki: cgw fyg cou zfd
asf: fpq kjm zqo yfh feo oqm
iwt: wrj zeg ccb
zqo: asf hgu yce dud hnx yxg ckc eur
cyz: ygl mdj ccc krz cce xdz nhj
wlk: pyx lqr
vkn: vdh iii jta
kgx: wkj
qzx: ehc spw zse vxp chl trf
qyf: tcb oau rnw oie tuy
zrk: kxk kpx kac rgw dfi
qtv: zyo ftd vpm dye pgd
tij: mcu ieb pwc cxs
uqe: ffa vrd gjx
tes: zxz yhq mtw jjx
eoh: udo xnu
jhj: gme iqd niw uzr vxy bio vld nlh dea
qfy: kdb kyf grz abt zyv cqw wqa kni kkb sed
tdy: rrm tdc qub ckb kjt ild
tub: xts shx qqj
sgy: qrx caz
efa: rkr
vrs: nxa shr
dqk: vkj wkz jep wnd zuo rgw yln
hox: crj ood ftl
nmj: ejb upf
vzt: efy oqm ily wfv yqs stf npe yrz icj
xll: tqu yvc luy
rki: zhs cfq fof wyt
iii: sdi xih vkn
yxg: mfr sed zqo mqp zij yha qlo dby zfe kpq dpo
dfi: sed zrk dpo kyc dyr mnr act wdv zse
hex: umf ysk rps dtw raf ckh igh
brl: kpg srl pan stc xdz oyw
hey: qtr
zhs: rki
avz: qec inm fhr kya
fkb: kqs bwe fki wzw von zsv act
xxr: sbj
mhl: qdn xno dnl vcu ajs mzf
rbb: ksh wxq nky
gup: lot spe eyh tcy bnz
xui: zyv exy dky hdx hnc tau
ztp: bvc nfa mvv rkz nnq
eaw: rvi ett vmj wrd fkv aky guh mod eqz
ctm: uzi aan pmc gtg btp uzy rxy
tcy: wzi gbs gup mtw
die: sqh srp qwz
tsk: vyl vkn aqw rrh bbj jxb qje
ojh: qtk tlf vdh iaf bpi zhv
mda: hhc cgx yln dzk hgu oty rom nne ftb vpg
kya: aye ojj rxm nid lqp
vqx: xtr
qec: zsv oer
ueh: ktu vjw gfm cqn wkz fxm tdc
ktu: zkf waa
mpx: heo cqw ppw ich
oye: hxa jlt fcg eca xlg epx
hst: wjs
uwc: mqq ebr jhn jhy xui upd xdz vrl deb
weu: bag xlk zmd nvq zxn opc gzo
ppw: mfp nxm fxm mpx
sma: znd vok
jeq: ody uvc
mxq: uxc wvu vcx avq
qfq: shu mtz sie vbr qyp qer cnw tqu
pwc: eqz jum vrd muf fhk tij zmo cur esy
ssd: whf jhp ngt ndx grq uff sxj fzr cha sql jyg jgw
gjx: ibp ozd
doy: ads xll qht
pab: nne egg esz act adf
vjy: ang qzr tqb gpn egg ozq
eow: sbb wrj mgt
fof: yjk rwt vjt rki
pvh: lmv ing dkr wzs
pcl: xeq ybg rft mqp csj ttw pdc bbk
kjg: tzh sad cfq zvy
tej: uon cpb mcc soj hnc yha yqs cyb gfz kqv
ige: ndb
fkf: vnd
wro: unq owz
ivl: hqf
qlo: yxg fej wti
kww: jmu esz rhn
lgn: sca yme spe bfs
tma: fzr tcb fmr ikr zsv kww
uxn: zpf fhk zxz fou luy mzr
muf: sca cds nen
cgx: vcx rct cqm lqp
cjc: pul kyf axp cwr bww
tvn: dzk fna crj ccc
mnq: hle pou vjz mmy
vlj: gtb drk wjo csj brl wkz vhg
ptb: vqa vjz sdt ove ibt
lfb: buy mqq
pis: qhz krk wde
zyv: cgq oer ujs qfy zdl
cnz: hle iuo wgq
zsp: xih
wgn: nle hwq kzr pcv pby
zij: niz wqy vtp yxg
uxc: qtv gsn uzr mam mxq oah kpg
xph: mrf snx bwe ozq cpb ilp rrm
ubk: xgj wzw hem khf uhu bww jjb
sbb: eow nds dwc tec yha
ufz: kzv qtr wzi
qah: lqw sbg vxy
oav: rke gdv
glz: rfj kdz atr odp vlb xjw
vkk: wde bcu fqu wxr lvn uqe
hrj: rae vgm zyg
fvz: ocy wgq uex xpn ejn
lif: qqp mlc tec
nxa: vrs uyd shr rsk zmd qux mkb
oly: oaz vfk idt xks olj
enq: ymi aeh fkl cnz wkj qpd uzi
vxp: jjb wqa
omz: qzp wjs dzt wwc dtr uoz gwg qaz bag zht mxc
lts: vjt kvf klw zxz kgx
avi: fou aku ija
zws: mww ezn oau qpv
yqs: tej cpb dkz
ptl: yfh wxw gzd fej
dea: xau rxm lhz xts cjc hdx nnt jhx
mws: wxr vgm wzx xtj mzr ckt bny eiw
izs: vuh ajh jyd kbz
ily: fhq xnu iyr kwu ylg siw bwe muq
iyn: pog lpk gkb fkv
kqv: gfz mfp xxr qdn aat
uzk: iam enk ccn kby hrz
mpu: zdc dyo
wmz: frn vxm
fhr: dye xwv rjk try
myn: tqk ihb yoo lzy vtq
wpf: dkr
zyg: tdq xks aui jpm hrj lpk fye
exz: xtk ovt
mtw: gtg
ebc: xwv mbz
kso: ads uar sca
aui: phj ieb dyo gpj qux vwi iso bgb zyg
xee: bxf
ory: jxh phj jzq kzf nvq naa
abv: mlc qlo oas
uon: oah buy vxp
ija: avi itb iyc xmc
oah: jyg vpb rcs uon uxc
tpy: qzx ngd kkb lip
rxm: kya fnd
dnl: vvp snx mhl tee kbz gfo
wvh: icl xst irv yvc tvb
eim: dym rnu uqr wfq ird mlk eiw kif
jyg: lrw ssd rcs oah ext
krz: cyz otx htx rzz nlh
bji: ppm kuz abv mam unk
bnp: cis blh qao dut qzj
mym: ezn kke dkz gzk qrq thz
xhs: cpn act
rgm: cqc vua cds dub luk
ayn: yik lhw etx bxb
wul: fje cbj vxy nlh ksa ild wvu sql uip
luy: btx tdq xtk ent uxn iuo ucm xll ghf xgq
vfk: kob
mzf: unk fmr
gpn: mqi vjy
abi: zzc ksq bmh lzo
ziy: fkf acs ada lts fcg ymo opz
lda: rfg tjt vqg rjk iub ois
sdy: cwl ahy icx zag wur zxk
psx: oyw jrs bbk jbb dpo
ngu: odz fom
pmw: nfa rmz
caz: kiz sgy
scd: rxq uuc ftq sca
whj: zpf ljh wro kma wau
xjx: pie sin
jwh: rxb mej xmw xbd
rwu: tqk izx
bpj: khf pvy ubf
lzi: xlj qvi kyq mzy thl
tqu: qfq xll hle ryc hny bqz
zfe: znd yxg ajs vtl vmg ljx wjo yte dro
soj: amt qkj tej xnu rzn but oig svs zpc
vbr: etx qfq qwz dyo ukr zxk
mfp: xgj nrv
rcs: svd oah
prg: vwi vua ynt
but: jhp soj gdf uip caz tec cou
zjz: zxb hpr uxt hny xxg esq
enk: tkl
tit: gde tnd yml xrg
jai: wdj xpw zdo von
rvn: mst tjt zvj
kif: eim vrs nsa uvx cmj shu ayn
wyt: gzo mji nwp wfq rki srs nle eqc
xau: zah iou
fsp: rxy jhg gxo cdl
kac: lti
luk: alt nlr rgm wnh hey ozd ksh
qul: wyw irw
jum: jbu jcp yim yzx kzv
nqq: sta ent cpz pyx mmy
vvs: ixc ebn tcr ocy
lmz: ybg ueh vsw gab
kvf: oso lts pis
qje: wzi tsk
wkj: bnd rvi kgx dub unq
jtx: qrx iob dro gau vgf dcu gnx dws avz
slv: sny xvv pog
nhj: cyz wyb mfr
rnw: lyj wyb fki kft mqq
kpq: zah xii unk vok aix
ffa: uqe tvk naa ogt
heg: jva vtp kez snx
mlk: ykd ogw
nnt: ivl slz dea
aqn: wur wtk zor
ada: ziy geu
rsi: lja kwa ttw wxw lin
jmu: iou eow rmf kww avq fna nrv aut aak
mfx: hqn djh ghf xfk nlw
wti: adf gfo nwz pyf qov qlo
bfs: jgk lgn meo zbd epi rgx bns olg eqp spe
vjt: lvn bvc
nax: flx uos aat dhi
opz: lwc djj hxa uji
hqm: cmj gaf oee jcz
mcc: rjk fxm ylg tej
ela: jsw avo ptb wdr xih peh
kni: kyc ejp pqk hds
iqd: ppu mie wzs
hty: fzo ejb mcu kby
fyh: uex puv cny
gud: mcu ukd mvv wwy
pid: nrl zpi nnq ccn nlr zxk
wqa: qfy nwz
xdz: yis ubf hnx hhc
rzn: soj
jax: shn bsf
bme: qux agx lqr fos kqt gkb
mkb: nzk uzk fye vgs
ekr: iyc yry fuw
hue: nui peh obj jta erg bxd
meo: yjk qxo
qer: ann vff nzk jbs cqj qfq kby vtq
nfa: iso kyq pmw dli uex qwz
rkr: aix efa bmt edu qov sql
tzh: kjg epi zor
yax: yik jbg kzv wmi nfu vua ixc
gxo: jhg ehl fsp
dgw: xll vsg xtk ceb aan uxr
itb: obj ija
lqp: kya lhz ujp
vcu: mhl oxa mam ryt
ggn: dbx nsa cpz
uzy: fbd abw szl
uyh: tuh acs jpm uuc
oeq: qpw kky wuc mrx
mps: fof imx ubz
aby: crj udo
wyy: tqk odp ewp xpr ipk jnx uoz
qyu: tct scn
iam: abw uzk sqh
odp: wwn wyy
aky: eaw vjz xss hey zag ubz
wqy: xmw ftl qyv zij yof rbu mre
sbg: drh atq bwe qah
kqo: oxm vrd
tau: xui nxm
mxg: oly foe pcv bdc tfh yme
dgz: pss try
ocu: egg vok skf
sfj: xmm vqa ckh hwe
pty: avi sol itb irv tgg ynt hbk uzk rfi
inm: avz fyg juv loy mej
xac: sbj jgw zpc sbf wrj mlc opp mal jhp
exx: foy aan jnx jeq jkr
jpq: dym tff aff
abw: iaf uvx iam rps hki bxb jyb uzy
gqo: boo jbt bgg mbz uwo quv
wtk: aqn ubp
jcp: xks jum jcz
kyv: vjw lcv srb fhq
sie: khu iaf ibp
tcb: oyw lbs
nmf: rwr bns shr qul hbk nsg
oxh: kou yuu wgd kbt hvm xlg vqa
nxw: kxk tdc gfo kwa cwr rlk gnx
uqr: muf ogw wdr
qhz: gim pis sta
ocm: oeq cce kjt htq
lip: gdv voj axp tpy xeq
vyr: dyh zba ujs gzm fuq oav uwo
ieb: aui psm ole taa ayn tij
bxh: ure iae scn mst ejp srl
qqp: knq lif
ejp: dws bgg kni bxh
gah: gme qkj alb
heo: gqy bio xxr mpx fej xqo wqs vtp
dky: rxb xui nid
ycm: axh mil
ylo: iyk see zns kkb gkt
bbk: nfm
mww: fty ryt zlf
rmz: ofc xtr pmw pcv xfm
fod: gnx
tpk: mvr xax
psp: skf koy odm cwr
oer: qec kiz rjz kwu
fnd: jbb rxm
rqt: gfm bww uos cpb elm dks agb oxa
qtg: gqy jva kky
wmi: fbd cxs grs nqw
wgd: oxh wkp qzj gzo
feo: stj aye lbs hdx asf gfg yis lqp
epx: mtc nva zsp cqc rrh oye
rgw: foc
qtr: gxf ufz lzy hey dym
vua: fuw
ksh: qvi rbb ibt mvv zmo
ggo: thk quv spb
pvy: vjw hgu
hhc: zpc gab mda xdz ipf xgj
ipt: vmj ann fbd
whr: fak vmg yis dws urt wxs
qzp: grs geu omz ccn ggn
bxb: abw rnu fbv ayn
unq: obj ixy wkj die lla cbt wro
msi: ypo hqf thk pul mal
jhx: dea nhj
phh: hvm jys xtr qzp iyn
hwl: vkj ild siw otx htq kdb wfv
tvz: dyr xii daz
qil: zqj gxf snl ezk tga yql shu
eiw: eim qxo
xts: znd dea tub aux
uzi: ctm zzc
rwt: nnq fof wwn
prj: eak xhs mfp kab gfm daz
veb: tec lja pgd uat szf jhx
hwe: srp ucm zjz foe tij pmw sfj mdg qhz
fuo: pgn aon efa
aix: sor zgw rkr nuj agb stj
uos: nax sma gsn vgt pgn rqt mqp
nlh: jhj krz
vpb: grz spb
zmp: jbu eyh ckh dzt jne
ceb: tyu wci imx iyn dgw xtj fbv qyp asv
uat: krz rom ryy mhl veb dro mej odm vmg xph aut uly iic
wdw: zeg bfh siv
avq: jmu dkr
ckt: mws wfq ngu kml ayn qlv
tqk: vlv gaf bdc myn uvj yoo enk wyy rwu jkr
waa: tqb
ibp: kmi sie nui mxc gjx
iyk: lmv zlf ylo
dyo: mpu
bns: nmf nky vlb
qtk: qhs ojh amo
cnw: yzf ozi svc uar
ndb: dbn sor edu sma ige deb tvn ggo oas
acs: ziy nue psm uyh dtw yoo
xjw: sta vxm
pdc: rjk slz hnx utu dky bgg dye idy opp
zuo: dqk vfh opp
jyb: abw umf
nyy: pww ysi
ygl: shx jwh han
lte: ffa eic uvx uxr
ygt: aha knq lmt
zew: loi
bsb: cce
bph: ycd jpm ufz
kxk: nxw mre vhm kyv lmv zrk
nui: mbk hue cjt yhq xxt mzy lvn
ody: eks hgj jeq xxt
uji: pbk nyy
deb: yja zuf ead ndb gay nlf
mzy: wny nui
cpz: rxq ukd vql ggn nqq
ure: bxh cgw zkf nwz
jxb: tsk kbq erg naa fkl ysi
noh: kky rgy kwu xii mej agb uka
jad: tjp rcs dns ebc myt dzk
tqw: kma uvi sol hdt
imc: zyo nfm vsw
pot: qdn iqd mqi tqb
ubf: ats nid kft nne bpj
jkr: qbp vnc
hsa: vpd xih mtc ozi
jyc: yhq xmm qph mpu
von: fkb rgw jai
iub: lda lrw
hqf: rke ccb ivl rbu ubf
agx: ysi szl fzo krk qma wxq bme vpd tjr hxf jne
nod: cha wze zpc ead ksa ehc kjm
kft: stc rnw
xmw: wqy ezh wdz jwh hse wjo zns
dwc: gmk qrw khf ydh
vin: tay ywo
jhp: ssd qlo
imx: zwc jlt
rjz: mlj lmv qai zel eak oer mcc tly
cvc: jmg eks mtz
wvm: niw tie wnd shx khd
spk: pwu
hdt: kks tqw
nen: kfc wny scd nho gya czs muf jcz
pmv: rhn fmk
yoo: myn acs djj
xby: eqc tjr
qkj: gah cms yte fcj elz axp dzk prj heg
wdv: tso ryy
fuq: iik vyr ikr
nid: ubf ndi boo ydh
niz: pft yyw sxj
ium: pan yvr
gfm: aut rqt rzz
way: rkq pxh olj hgj xfm fos lts
ysk: hex ywk
ovt: yzn jeq zwq tay exz ywo snj
asv: ceb
voh: cnv ood lqp kfv ilp ojo avf
bar: xaj fkb lbs ykp ghb rcs npe
atr: boy rbg
see: vyr qpv imc lyl rom
rps: pts fcg abw oiw vgm hex yzf bag
pog: ofc slv odp cjt fce iyn kif ypl
bgg: cpn ejp gqo yqf ene
spb: ggo efy
bqz: wxq tqu kzv
rae: tfh hrj imh zej gos
dhi: yaj nax tfx rzn
zba: ydi mqq gzd vyr wcn
zhv: hvy
ymi: dgw ibp nqw rnu enq rvi zsq xli icx
nky: rbb rxy tes mcl bns hco umx
odz: pts oou ngu
btx: luy wvh fqu tga
uij: ckb vrl oxa
ljx: siv yte fyg
zxk: pfy bbj gos
yjk: zdc rwt vqr fof oee ekr meo qje
nyt: vcx aos imp zuf kww dby qdn
qpd: naa
vfh: siv lti ido rct
qlv: ckt tgg
xtk: luy ftq mji guj oye exz enq fvz
cxs: tij
qph: bnz cur sam xgz hxa wmi jyc cnz ekr mlv
pby: hle czs ejq
xmm: sfj ftq jyc
cqj: itb acx aan qer igh vsg
vxy: iob jhj
pwv: jrs gau
gau: fst gdf jtx pwv trf vmg
rxq: mtw cpz jgk frn btq scd lpk yim
thk: scn xno mgm ggo
vtp: idy iyr xqo elm
xya: ehy cvc ole nzt ent hpr czs jnv vsg lfe ybz
ryt: iyr tjt ifn
cfq: ejb gos wrd xja kma rki hrz kjg
ixy: yzf eyh zdm mtz
djh: tnd xli
cds: uyd
ezh: cqw utu
ckc: zqo rwm vuh
mbz: btb rfg cqm
dzk: qkj tvn xck mda mgm
nzk: mkb lzy uvi
jyd: jjb
lrw: dwf vxi iub pwv vtl svs jep wtg jyg opp
wci: xer qpd gos zsw bbm pmc
ghn: srb gkt rke jwh mpm kfv vrv cqn dsa
stf: pot hqg tjp vzt fhq pmv wze vuh oxa amt
uoz: xrg wyy
rjk: fhr pdc lda
shu: qfq ccn
mgm: pma thk yte mam
psm: bcu
kmi: jbu zwc nva
lzo: mmy mod gxf
lot: zej yen gci xtj wyt gup bcd uxr tqw
sbf: xac zvj yte ayc koy ygl cyb
ucm: oou sdg
dud: zqo bfk kdb vtf iub
oqm: asf rhn svd
mtz: qfq ifa
igh: cqj wxa qmb
ido: vfh siv
kqt: hny iaf sfj rvi pcv
uzr: uxc srb yqf srl ptk
idt: dtw imh cmj cdl
zuf: udo khd iae frh rhn nhj rct fod
bwe: ily rft idy ciy
xrg: nsa ejq xmm uoz
cjt: pog
fyg: kki wdj
oyw: rmf tcb ypo fcj eur psx brl htx ydi
psr: qux xby xfk fkf zsw bme nqw
qqj: prt jbb
fhk: pwc loi uxn
zzc: uzi hnn cel dwe
cny: oiw bvc xgq
vcx: nyt cgx kpg gdf mxq ygi kwu skf
cyq: qma nmj
bvc: jxh vjt olg zbd jug lwc yax cny ztp
uap: gwy jys pwq wwn
ogt: hgj nlw ghf
geq: cpn bji gau juv zdl wcn ryt
dxb: whf fpq jhy abt wcn tuy
gpj: puj zhs idn
ubp: fkv uzi hle hny zqj wtk dyo
zqj: yim gzs
wzs: qol bxf
mlv: lzy vgs
cce: khf bsb
cir: iju nja mgt lda hnx pss hds
mxc: dgs
vwi: prg ckh abi wde vnc ejh aui
ujp: wpf mqq ext ccc lqp ndi try
pua: lja elz
hwq: zhv qvi tyf ivt yik hnn
mej: jai jwh noh inm
sdt: xxg pps ptb
lhw: ayn kdz
tjp: stf yaw ycm
wze: iik pdr
yfh: ptl max
nhx: ptk eow jig skf ceu
taa: goh ieb vch kyq
wjo: zfe try vlj
esz: pab nfm pjj kww avq
vnd: xxg fkf wau xfm
yzf: ixy cnw
qrq: pie nax aug mym wqs
alt: tui opc yoo luk xzw xlk
jug: mod psm ole shu iii jmq
ygo: unk
dws: clt sbj whr mxq asg tpk ejp pjj
ypt: ofw
oue: pua mnd kpq ido bsf
suc: kbu rgm aku ody zdc jjx
mcl: nbs mod yik
bgm: jnx
lpk: wzi idn iyn
xgq: luy cny
ezn: mym aow
ifa: mtz hco rfi wrk dus
irw: pyx xfk
aqw: lfe xks oso pdo anz tqw
kfc: wrd anz bbj xmz
gfo: wti
pcv: kqt wau
ejq: ofw pts pby xjw
lfe: ogt rsk vjz mbk nle
mmy: xtr mnq
pyf: ild urt pka rlk ois
rsw: olg bgb ysk bme nlw
nds: rmf dzk xqo iic sbb pqk fod wtg buy
rvi: kqt sny qul wkj
wrj: iwt hqf nyt xac ayc fty msi eow prz hnc wcn
etx: imh jxh vib vbr zej ipt jnv
gya: jbg uap zdc
kdb: szf oav kyf lty max xaj oie
lza: dus szl fed vvn dwe tui
iso: rnu tui wyw hst aui
vvn: lza jmq
cdl: uqr doy yen ubz fsp btx idt
ppm: chl oer ccc oty npe
vwt: oou zqj lwc
sol: tqw fuw eca
gkt: sql vgn ojj
icl: qux wvh bdc zxz vrd
mja: svd mre csj avz urt rzn mie
ojo: qij efy yjx voh
iju: dkr cir hjx tee mtv cgx vkj
ang: bio nnt oxa kjm vjy
rfi: ifa xlg btp yxk foe
mqq: vld
wzw: ubk vzz qsi qyn gkl
xpn: yvc bag ycd vsg eim jsw fvz cis sdt
kiz: khq zkf jhy lti aha caz ftl unk oer
hny: iwd eca bgb ubp aqn
lbs: aow feo bar alb uff hjx nmy tcb heo ciy wkz
khd: zuf
rrb: cuf
gay: han myt
mlj: czk
ebd: ygi nrv niz aos gdf
ird: blh eim nsa bny eks yik
gzd: nmv
fzr: fuq btb dby aha tma sbf ccb spb drk ujs
aat: kqv nax
lty: fgx ksa tuy
mre: qxj wqy
jhy: dxb gfg srl cha kiz ttw kki rtq rft vtf
