tpq: kua drr nxi bos siy aoo
emf: pyk mdy cly ual
kks: ena tse dxi sdg pte
mwk: jkq
nxi: her
mre: uom bly hxc vkv ihb hlc
sih: wwe yed cmt iyh
uld: egv
qvw: yhs ols
bmi: cjf rzl ueg rgu uzr ddf
qrt: wct iyh fjl anq ydb
tyg: mro jkq ysb fmu sls
nvw: wvh yad wat uik zgq vqb yih
wmk: bka smz fxj wex jff
phu: zxn svn klg qck
fzh: ake noe wgz
owe: lwj jrw yoh dsn
aee: gnl zmh
rop: cuf guw tmy
ycn: szq fge ugh mmy zjn jpf ttj rqt hdw
jzs: iel ejw ohi sls vfw iim
wwi: rog kow web hvy uxj aem
fdc: doi odj ozt ttw
lnv: vkp uwm huo uix
toq: kwi bjn goh vlu yuk yzb rbs
hht: iqd abg rtv
qya: ckq
qsd: pgr
hml: vkp iqi ulx cus lwj
xow: zwe kmu zzo zbg
bjb: aly izu hux
fau: tet hkn jbx bso hpn ooe
qlb: uld lsp nqt plj xdu fzj
pfj: btt dpt wnw haw
clt: rtw kam gkm zoy nsq
txd: wkp suk rzl cvn ssf htr qnt
ojq: xok
pax: rxk haw
xds: ptj ocy nfr non jmi aeu xre
ocr: bhk rtf
pzg: naa nya bra xeq chm aud hdo
ude: bfl sox cnb bme
nja: tdh iun izv ygu
ufr: kta vog gwn
paa: hjy kke utt
qzk: luy
vaq: sff pao vnv lue ren
dlg: aco
qdp: nqo
vja: vem hyf tkk adh
akl: rac fkp pnd efw
fao: xvm xsl wib ryu gpb
umf: bjc glt pqh
dgu: jou fvx vec vkv ocp ahh klg srt dmv
wta: xlt eeu yci oyd
lpe: quc jul jmc
jzk: qaa uoc
trv: uno ezg ydy pit jbb bej oxr
rac: ygk akl les ogd sso ihd khd ioa
wbk: bso qdb
ibh: qbd
xqt: tyy gvs oqe
jov: vfo fmu zuh
mdo: gaa nbd llb rjk bot
xev: tvq htr jgf rll eiq sli glm
vme: ihg bbb amt eep zsz
szc: tvh qnt hom
ake: fzh meg
ldd: qfo yih bhk wej
egn: goi sdn okv jpf
xgw: bvl gyz zsy
vkb: jjw ull xoo ypr plz rch vrh qcj iow
wix: szq hyi
jvk: hjq rot zbr zlz
htr: sde dim
fdb: izh oyd vmz qya twn izu trs
tud: fzj nap mos
ity: gwn szc srt ysb mhq paf plj
qmd: non mrr ldh
yuq: kdf qpx
zbg: dxg sxi bmm ptq
lad: hyr iyu egh wbk vwj
ykl: blr poh wsn bfy cte dbx
xvh: xac zqh xeq ijc usz
amv: def jpe
wkp: vkv asr wqr wne ogl sou
rog: haa wxo xkz wcr ftz
aiy: dpp qzk oqe
vnv: vaq rxa yry nbz wiu qli
hdo: pzg zxl lue nei
djo: zva
dog: ygd tet vwi scn
fkp: fzc evw akl
zgq: ifb atd mdy dqo ocr nvw azh hlc ynb
ezg: eie
tkh: oyj mwu usb vfm
icb: uzw plz azl oxr pju
vnp: ibt lop hyi lad sae ygk
tgt: psa ckq
lzh: vem rzp goi bra
svn: tpf ctv phu
uqo: ndl ihn uix dim
xmf: yuk pta
jay: air scn lkq
hbo: izx ttj tmy uhy zys wnu ipm
cou: lop
evo: eeu bdj nwj
jro: iix uys ojq gfo hux bgj lqz arc fne
ifv: luy tyg igo bpb
uxp: gah wun uez bxm
uix: ejn mup cga hxc lnv
xpg: jcl ujv gps rri
bze: jsb
mgh: cow eri qgy ajh vhg
mro: tyg ohi glm fmu kta
pfe: lku ard hqu kro
dzh: gah nls
eri: foe sfh xok
bex: ixm ees vem oth opw rqq
ufw: ijo ztm dsj
eeu: xfs
dao: ydb qli xoo evw
qkz: eln vyc
fms: wah smu dim lfz
bjn: yxc gzg qnt
mgp: mwu imn kyq
bxm: ydy uxp gfo
zuz: xcs efn eso cqf inm
hvh: sqw zws ydy dca
ztd: inv ojq trs mgh wcr sbl rog
khd: tet vgk ijy rhr mov ppn cxq jpe
bjc: mdr atd qes ftp hjz flp
iug: wlb qvw yuq
ogl: tdx
zrh: psa iow hqt
wiu: seo hkn vnv suy
uxj: kwt zzq wwi rup roz
wcf: zpn ubj
ezq: qol nrg ifv
jpe: tdo cwo ryt amv
naa: pzg foe wta iyu zud sae awz
fud: bgj
qfo: nqg fho rcr qvw lff hme
qgy: oaw sbh
kua: kam lie gvv
vxt: kxc btj egw
cxq: ctt yls aem hxo kuj wsg aos inz grt
yxc: mzx ncw eep siv kpn okq bjn smu dpa
gps: tvi xpg rhr
wrr: hda ypz zwh asr dpa noj yie sgq goc ptq
oue: eso igv fle ezq
siy: hoy gsy
qvj: wzm xok pmc
bwp: gla kud mmv zrp krt nbd int ppn yqv xqo mun
jbx: zuq ena nbz ihd
lht: svd ick bme
mqf: tfr
xqh: zva btw xmb oue zsz abp
her: xkj utt uoc lkw nxi khu kmu qaa abg eng sgq xre
iqp: yko hvt zla ufq tkk mrx otp lnb gfh bgl
yua: ood xnj
toh: vap udw iow
aud: rld txf pzg rjk
hle: yfe ifv qmy nap qiy zhs
guj: jtg edk zrl qom
egu: uqi dvj xeq fud hwd ycl
aqb: ozt gla
ctd: yls
jfo: llb btq ufq bvl ull dmo zjn vwj
qdb: xfs sfh dqh otp udk pdx wbk nwm cmt
wib: rll zhg yun jpg fao
mod: eln bso qti jwx
dbk: wzm iid
yqi: iid ryt ryv jxi dsv ufw sak jba
szq: ycn elx
ygk: tzt efw
qtq: myz pju itr
igv: jmi mfh mhq
foe: eri zxl yry
poh: cap vog vxt kdo
uyj: rpb lpe inv
jcy: cmt uno qqi zap pdn jxi mod
xac: ury xvh
mdr: sde uqo hjz bjc mnn nrg gnl
eep: suu gjf
sxy: yvi zws qti lbh ftz mko czl
bit: mmy qfe ypu sye
qbc: paa kfb sij kwc
ipr: nos nls abx kkr loi ypr jlr
oaw: dao bgl qgy
jfw: fzc ybn nak vhg qtq qrt
bdc: oxi kow wfm
cjf: ajv
bgo: ggo ygd vin mun
mov: iyu rxa khd
ifh: rmk xmq unq dxg
xgg: qpx ztb jmi hyp
twa: usz tfj hye ewo pao
hqu: qaa dsy skt qom htu mrr pfe kwe
btt: jso nas jkh dsy guj wxa pov xmq xsy bmi pfj
tbv: gms goi okh bme cen tkk xxo
cyu: ych xey
wzm: ynu qvj goi sww
pxt: bgj kkr zao web
ejw: nyy lbq szc vlu rlk kxc
htu: hyu non rzr dsn avx ocr wdf lkx
css: hom wxa xjj gtz
wim: tzt asu myz qia cbo qbi gfo pay
jrw: inq owe
bkx: nvw hyy rtf zid nee lsp gpq xaj
yqw: ryv cen mgp ncp std inr
lcr: vap lue ndq
wuk: rwl qmq vcd bow
kwy: hjz hoy ych fjf aee
nyq: izh mko vgk
ypu: btq ibb bit
bjf: aly uvy
dfu: vnv dbs puk gpx fdc xxr ydy
neb: jtg nzn rzl rwy
ooe: chw otc ijc uhy
ptq: rrh zbg yii
usb: uhw
uom: mre kmu gur
jff: uvh plg ahh rwl clu paf
mfb: trs mjg yls tdv azl siz ksj otp
kvu: mwd egd jsh dsv qfz fhl zxo
sum: egv xds pzq bze mkf ymt rot
lak: bvc jhs lzm
roz: kez sae
cap: poh uzr foa bpc
kdo: ivc bze rlc poh
obk: xzw haw mwk tfr wqr uyr sto arr
fbo: okq zxn oqe lnv
zuq: ajh jbx lpp wix neu sxt xqo
sls: jzs ojh jhs ulx tyg aoo
rcu: nlv cdm wat stl rxr
siz: mmy nkw nzh mfb
igp: icy zxn xcs taa uyr xrn
nkw: sfh siz cdl xok
ezu: czd nwj
ppn: czw uvy kic qda gfo
fsj: kic pwp adh sdg
hmd: lin tmy jdz xya
vav: zpn kun piy xgw xye
juw: uvc ihy lie cdp avf
jpg: aab rtf tdd wib udg cdc zjb dpp lkw pfe
enq: fsp nkh xoo kjt cqv qdb
aco: ztk jod eng prt dlg
zxn: eht lkx phu
ckq: tfj tgt qyh qya
qoc: pbb ncl etr yzb gpb sna dsh jiu
omk: pse lth inm nja dsn
jgg: uyk wlb tjc awk cvn
khh: tdo cqv zdh biq ddb
yyi: tsr eln qya
wme: cqp khp xxv vpa qli hye nkh duk yqw zfw
abp: neb kpc bbd ehu
qnt: bei szc
gsy: iqj mrr siy ihp zks ysb uvc
ull: gmx wea xpi
mmd: idf
ljr: soz djo eiq bmp
ztl: lkw fyh
bxt: eeo pax qzs
glr: bgu duk zdo
stb: ono aos xya kwt ezt
pcz: dzh rov rup rqt
eht: qfo qiy voq zxn
inv: uyj qdm
fej: kxe bmm jhs jod jys zwh
kkr: ipr oxr uqi
dxg: ifh drr uvh nvz lwi vib ztb zbg
iuj: shs vib ldh
zge: hda mqu zwe
awk: ssf bwi jgg jgf
jdz: hmd
rgu: plg bmi abg
mzx: iqd ulx yhp
evw: lkf fkp sgm dao zme gms
qgq: csx mmd njv vlu ten kfb lzd ncl okq huu dfp ztl
ick: wti qow onr
dmo: dpz xkz dfi nya qbi tdo
igy: nzf xre ncw mos
uwm: wmn nzn bmm sou skt lnv
ijy: dyx szq tvc
jyw: jmq mtu jiu
gex: vyc yaj xeq kud tww jpf
ygu: vev zqz
jfl: yix mrr puz amt
cry: uyu jcl amv dyx bgu otp
iun: krj
usz: jjw tpe jqu
zzo: xow
zxo: llj axh stb kvu qgn xka vnz vly eie
oif: kjt soa
zpn: xoo whg wcf vav
cph: btj soz zrl
jsv: cnb ojq dca aos
hwh: rot uik
epv: jbb tzb
dnm: kyq fsj hww dbc les
ujv: xpg hif
zbr: jvk btj xsl bpb mdg cdp dcw
cqf: xvm
qow: ick plz czz dao pco sov
tyy: rzl ifv xqt tvs wek qoc
yii: bmp yuq btj dmv umf vib ptq
cya: qkx
biq: zzq suy ein
ren: xqo qmo ugh asu
egd: fjl txf
eie: jgv ezg ynu sww rzo
gfo: wim
yko: jes iqp vqe
nos: ugh
nqt: rlb rbs iqi mzx fyh hjq aiy
tet: fsp
vib: iqd uwg cne iuj tdh dxg
uys: jro cou hvh dro bgu wgo hdo yvi
igo: drr zhb xdu lzi ifv
pzt: yva vup phc biq oaw nck ogd
glm: izv mro ozo jfk zhg
iyu: mov
wqq: wpg afs elx
lil: nef vwx icy mhx pyk fao iqd xme
rlb: rpt lzm qmy dto dad qzk nqt zhg
son: krj sxi kwe
rjk: mdo sck epv uxj aud
psa: bhx zrh dbc lvj tgt mrx
ksj: qeu phc ygd mfb
qgs: tdx haw imh
nls: ipr tdv dzh xgo
dpy: ayj ldh yja izy goc
dfp: avk siv zid hql
smz: wmk vfd qhi zow lbq iqi elm vhj
wwb: mdy uoc zgl
ohi: lwi bze
cuf: rop rse ovk
rwl: zwe wuk jsb xot nee
nqo: kyu qdp qsd xwi jlp yuj ydy rjk
gsn: dto dpt dlg zmh zhb qom ctv hmg
drd: non ual ozo flp qqw avk
nzn: neb pfj ryu nas uwm zik
chz: ktf pao jgu aql gpx
iqj: tmj rcr csx ynb gsy wdf ncl krj kxq hoo
xlc: ztg aeu
vlu: qgq fho ejw
lkq: xxv prp
jtg: guj flv sij wqr neb
klr: kpn kwc kmu
cus: hml bow xcs rll
uqi: xoz egu cmt irt tsr kkr ufi siz evo
bfy: rjr tjc rlc
ogd: vjb pzt hvh mqb rac
fxj: lfz xre vbj wmk edk pcs oqp
pdx: zlx pdn lop qdp sdg
sia: sgq zgl shs fbw
whv: wqr vec rpt
xjl: rax wgz fds zws ukh
pnb: fau iqc onu lqz lue zqh dbc gsp ztf
zwz: xlt egh std erx
asu: dbs jul ren
ten: coi ejn ygu lhy
ywt: yhe nlv
som: ird xey jcv ocq
mhx: bku eso
ipm: tzh pmc iky jfu xgc hyi ygv
hwz: umf wwb zzo noj gwn iim kdo prt
roe: bmm clu gzg wdf
gur: luy wwb uom keu hwh zxf veh
ozt: ptv kuj lvj aqb zte
bvl: jfo cou pdo xgw vjb ygv kic twa
fle: nov
unq: ifh
fhz: jiu dkd stl hyy lzd lsh cap keu foa zbx tur fcg cdc lkx
rxo: uaf ddb dtk oyj cel xhb
qzs: bxt jmi xgs jdq xah nov
zhs: jys oqe hle vhw xqt tvs jso
dqo: xmk jco xre zgq vbj
nas: zhg dlg hrb drr zjb
xoo: hmx frg vkb zpn
ifb: etr jpg lhs wjn ulx cte zgq nvw dpp
wdw: tww yry
mby: xax xrq cox
zys: elx iqc fis
mcn: nyy suu zgl
sli: siv
vhw: ihy
wpg: oif ees mov xqo wqq wwv
idv: inz qsd rhq qgn
fjl: pju abx egd
oyy: ndl xgg amt cdc bpb
wwv: xgc jlp wpg
uhw: rog dqh qmo usb udw zte
tgg: vzr hhq uls atj
irf: mdf xey ord bei
lsp: bkx
eiq: nvz ljr kro tgj xev ico
hda: btw vfc zge kke wrr klt zow lzm kpc
ism: jtg sxi ato xax ddf sls
awt: vap vfm
kjt: imn xxv bso vly oif bda
tfr: clu mqf pse obk
nlv: ihg ywt avx ndb
ddi: zmh zks
vjs: vec hql ojh ord zbs
rbs: mne toq ayh
fdd: mwd yeo
hix: nkw lcr rov sso
gxh: vem xok ufi eia duk cjl
ych: mhx eyq zah iug cyu
ita: kyu rup llb mgp vwd svd
yih: inm
npm: mnq xoz kow
hww: neu dnm rfj lin nvh hhq xye hux
elm: yoh jso ada jkh
pta: huu zow xmf nvz
wgz: fzh aud
wha: zdo usb gbs
pdn: lpe suy dbs
int: gmx cmu qbd
kdf: tef kzz xlc eng lhs xde jso yuq fmu ldk
voq: tvh dto ztg aeu vog hrb
fho: owa vlu jod
ixu: wti ein
sou: wkp uwm
jso: ato
mjn: wah tdq jkq fyh qhi nfr
emx: kdz hyr
avb: sye tvi
utj: uls wwi
fjf: tjz hyu soz ope hrb kwy dsh lwj oat
ard: jdq zsl oel kzz ahh zah omk pfe
ejn: uix gpb puz lkw zon hjz ten
ddf: bmi
qbp: tei vqe zpn xoo sfh ouj zfw vsc
uui: yry cgq vca xya ake ykp
pbb: rwl qoc bbd gjf bpb ndb
zdo: dbs fis wha
kuj: iky dfi mrx
olw: sfh nqv tet wcf jqu jcl ezu
gfh: iqp qyh lqz mnq wfm gau
oxi: nbz bdc
boz: ibh bso gds czw jpq qti
yuk: smu owa guj cjf pov qck rjr xmf
vly: xxv ygv aos
iow: zrh duf vkb
qti: uhy xhb ecd boz mod
zsy: fdd xgw xgl oth xxv nvs ykh
ezt: fhl sov loi
tsk: wwe sff ddz
bme: lht
srt: mqu
gtz: qck cly css suo xba tdd drd okq
ukh: les rhr xxr
ysh: noj xah ndl rot
hdw: jqu suy inv grt hvy
grt: cxq
xqo: zuq aql seo ren wpg rch czw
klt: mdy ysy tfw
ptj: xds lsp
vgk: khd zwz ubj hvy qbi dfi
hme: uij ual
skt: iay kmu uwm nap rbs cdp
byy: hmx awz tkk uvk txf
nvh: sye hww sxt
fvx: dgu qnt poz huo hll vev
ovp: vqy xya atj emx hft jlr nqb
jgf: ljr awk qes xev
cen: ahv ygd dqh yqw bdj loi
krt: sbh qfe uez loi xgw ypr kuj
fbw: sia
xok: gxh eri ojq
ndq: lcr klz sww nbd oql xye cnb sih
gpq: zsz bkx ayj vfo wnw
lnb: rpb xye xkz
fyh: lbq hoo ztl
duf: tei goi iow pct tet iyu tsc tgl gah
tjz: cyn
qwo: aly avb tvi nya wta qjy xka hnm qno
coi: atd btw pov ten
sck: cle sgm wwi rjk fzv
snf: pvb jcl rld oql fdv
rqq: fdb ick bex oif pgr syy qkz rac zla yqv
obu: lsh zdj ohi som pai jvk
rxa: lvb vnv evo irt nzh vyc mov anq
rax: iyp vja jta fdc xjl
odx: jdz ktf fdc jbb gau gaa ezg
qmy: xzw bbd hle rlb qiy eso kta
tzt: ygk dxb oyd fud
tpe: ykh ibt phc lpu ena
non: qmd bbz
hoc: ein cqp
kam: clt kua fzj
zne: yry epv ncp
uij: mro hmg xaj hme
ryt: amv ewo jpe iqc cqv
xhb: qti kpk pau oxi rxo
yun: djo wib azh jyw
hyy: nsq hom xrq kfb aga
njv: qme dlt qgq
uik: tnn
vfo: jov vjs zbs gad gpq txd uhn taa lbq
ynb: tnn wps ajv
czl: bvy qqi mgj wiu yua qeu tdo
xis: abg ahh
imn: nwj ous mgp twn kjt eie bot hyi
yja: dpy ual pse har mca
qom: gsn eeo ihn kub guj
sgq: sia wrr
jmv: hqw xxo kyu
dmy: aot avf kke dxq xmf cdm pxp xso
uoc: jco jzk wsn
noj: uom rpt ysh zmh bxt hwz
tvi: gps avb
pov: yoh som ndb coi ndo oxk wsn
avx: htu eso cpz vkv qoe nil
lzi: igo eng wlb
vqb: bwi
kch: suo rll ldh eyh flv egt oel vec jco atd dmy ndo
dml: kud neu
cjv: ada fxj dcw yja iqj adu mos vog nqg uld pmj xqh
cfa: pzq ayj neb iuy qmy tdq jfk eng
njg: vjs vjj pzq
jxi: qia pte jcy
gjf: uzr haw
ttw: qpa uvw akf fdc qvj
zla: bex abx rqq uaf ous
ico: hht cgp
gzi: lqz ddz wcr gtx aly acs
gzg: bjn
vwx: zbx fbw ihb
akd: gdv cte wej
klm: lih ous qya qvj
rfj: gaa hww dxb djr qmo
oxr: kkr iov trv
vup: kud ezg
aeu: mup tpf xds
ktu: mdf egw tvq rll jrw bmp vfc efn oru ysk qqu
noe: vsl zfq sbh yqv
mfh: den mmb
mun: eln fhl ccb pau bgo bwp kje
kez: rhq roz wur mnq rvi
mhq: fbw plg suk lzd ity blr aot igv
huu: qgq xde
llb: mdo
hpd: hwd btq yko llj nkh
oub: tvc fyi gsp fcy zte awz
ioa: inz zdh qgn
ksb: ypu vqy biq ous ufi tgt
tvc: uka ijy vbw
gvs: rlc pcs uhn rcp xqt puz
yeo: hwd
wun: uxp ipe vzr
ldh: iuj jov pcs cgb
clu: tfr stl roe
dzn: ivc nqg jhs lku xmk
syy: rqq klz
gja: hpn ydm zjn chm mwu ygd rch
ahv: tfj yyi xwi cen tmy jgu mjg egn
ufi: uqi avb btq zla ouj cou
xaj: uij ivc azh inq
xre: igy nov
vrh: tei vkb wbk ycl
mdd: taa xrn mwk ihw bwi ldk iuj
yry: vnv dpz
elc: nwm qpa chm xuf
jba: yqi zcp iyh
plj: qlb hmg ity ord rtw hme
sbx: zlx chz web opw whg
mmb: mfh djo
oat: gee mqf aee jtg xah zhg eyh xde txd zti
tmj: tvh ewt tpf iqj pwd yfe jsb
rtw: mdy uld clt ofr mdf
idf: xmb izy xgj mmd ulx nlv
rzr: bos htu fws mdy
wkf: lfy chx fhv kdz ajh ttj pay bdc awt
rtf: nsq ocr qnt ygm
jbb: trv jdz epv jxi
nil: izv rcp
yoh: vxt owe elm mup lzd
suy: wiu yed biq mms xnj
qpx: yuq vog rwy den fws wej xgg
abg: hyu yad mca xis her rgu hht
eyh: oat uzr foa kwc cij
lgw: xzw cgp mby hlc gdv pdg pxp
zon: ejn icy hlc zsz mrr phu nyy
sqw: mdo hvh dfi oxi oyz eia wxo
wgo: uys ypu pxt eri uxp ztf kje hux ecd wxo
qbi: esj vgk gbs
zzq: glw
mmv: bwp idc vsc erj piy lvj lht dtk
plz: qow rup nde wix wdw vkb
ubj: mms sff yed
mdf: ihb pai rtw ryu irf
zhg: egw oat
kub: qom xot clu
onr: qkz gtx fis ick
qdm: inv sov
itr: gpx
anq: qrt
cyn: ftp tjz yuq fcg khu
rjr: bfy qme zxf yuk zry mmd
rzo: vgk rqt ibb dfi sae
zuh: npq xsy ztb zti
ktt: lkq hft wwe eop cjl
lkf: cmt ajh
pwd: adq mdr rxr sdw fab icy qoe
ood: gyz pct mov yeo azl bej vca iyp yua
vbq: xot fab fms hjq ptl xah fws wps
ddz: vin
zgl: ndo sia
poz: fvx kam avf ymt ezo rlk zwe ldh
jek: qkx jfu
pau: cle gla ihd lnb xhb fdd frg
tvs: zhs btj
ncw: igy stl xmb cpf
oyj: jul ees ppn fzh pdo dbk qdp tkh
okv: tvi asl acs egn jes cen gaa
ucq: vhg jgv
pzq: cfa
ysy: klt hql gee sli pmj
bly: mre ftp
bdj: dsi cen sdn evo axh
cdp: zbr
lvj: pay fne ozt fcy
gms: evw mmy tbv int nde bhx guw
fhl: ggn awz mun ezt
hkn: wiu pco fau egd
eln: jmv qkz mod qfe
iim: jzs iqd
ird: gvv mnn xey fil dlt stl som
xlt: wta zwz nei ooe fcy mkz bjb kqa
zlx: frg ous
otc: gpx amb tci sak gbs chw nqb
xkj: ihg tfw cqf svn bei vkp vhw
hhq: tgg rvi hww nhr
wct: srz qrt kje nyq elx cwo ibt npm
wip: ktf jsh jta qsd pit cbo arc fof haa jes erx
ury: xac dck
suo: dsn edk rxk kch uvh rcr bjn taa cgp
pcs: izv vme wne gvs nsq pai ldh
tvq: zbr xlc fho
tfj: sff ckq dvj ahv ufq vly
bda: vnu piy
aly: inz ctt gzi bjf bgu bjb gdf zdh
dsi: aql chw lin
bku: ajv mqf wne mne mhx
vfc: hda lak tfr
vcd: izy aoo wuk
hkj: lie cox
sbh: krt
okq: qgq fbo gtz qol
nzf: npq igy
lvb: iyh
nov: qzs
kwc: qbc fzj lth klr
sso: ouj rac jlp hix
ryu: fao mdf ygu ztl
wtg: hyr hft khp djr zws xgl mov
jxr: tjc bbb qzk ysh
hmg: uij
zdc: cph dlg vfw tvs gpq tjz
cpf: flv cgb kub
dtk: rxo jag mwu elc amb aem ztf
ein: fgm biq wdw hoc aql
ugh: ren fof ycn nos
wek: tdf pfj cga amt gkm jov vev xlc blr eye tdh tyy
saz: les zdo kqa
taa: vfo uhn njg suo wws emf mdd yhs
ipe: tdo tgl vmz bra zrh wun mjg
hft: ktt svd rov ftz
erj: wgz cwo pju
uaf: zla cle
goc: wrr kwi qol gyu xqt lie
zfq: zzq wiu noe vmz ybn snf inz
pdo: ynu
tdf: rtw utt iqi jco zzo owa gzg
cgq: jdz uui vyc vhg nqv
mgj: czl xxv zjn vhg khp yed zud
bbd: qmy pbb
pse: tfr ndl yja dsy zzo jfl omk bbz
kpc: ruu hda keu
jfu: xgl
glt: wnw nsq yix qmq umf ygm
rpt: rlb uvc noj whv
qme: rjr njv
ayj: eoc kke
xgo: xut onu lpu jes rij sbx zne nls
vyc: qkz ttj
dxb: rfj
svc: llj nat vqe twn kyu evw nck jba
dwe: wea zjn wcf ftz cou nbd vcu
asr: djp
jlp: qda sso bvy wwv
qol: okq goc
xxo: egh
zcb: vzr fge iyp djr nka awt
wsg: ygv pit bso
iyh: lvb iky bso bhf
czz: mko zao rse hpn qow
vaj: rxk bpc dsy
uwg: ypz uyr nqg lth
chm: gja elc pzg apl
lbh: ggo nbz nzh hoc
grb: pqh tvh hkq sna
izy: dpy xrn dad ogl vcd
hjy: csx paa fle jmi
ynu: dzh pdo wzm
asl: yua okv gad klm zud xnj nvh xmg lbr
ykh: sgm nwm akl dro
scn: rse ufw cuf kqa jay
vca: gds ood
bbz: pse zik non fle
ees: ypr wpg gbx
vkp: xkj yhs hml
dsj: lih
gyu: ddf rlc suk suo goc qes hjq kke
ygd: ujv cen ksj dog wey bgo anq cdl gja
tur: mco
mne: lak nrg rbs bku xde
arc: jro dck
cdm: ezq asr igv
zik: nzn mmd ezo bbz
ihg: nlv prt xkj vme lgw avk vog klg aco imh
ivc: egv
nee: xsl bkx rwl bzv vev
esj: akl hye haa qwx nnl
ypr: udw ees okh kqa
qda: jlp bxm nya lbr bdc sxt
jul: dxi lvb mgj oyj vzr lpe
bvc: lkx mup
jta: air wip
gsp: iix
hyp: rrh siv
hjz: wne ejn
mmy: pwp bit
luy: qzk mco ifv xjj vjj bmp paa udg gur
zqc: ssf aoo qzk rrh ogl rwl
ihb: vwx qzk skt wex mdf mre tud csx bka
doi: hmq
vnz: gla txf cya
nqv: usb ibh cgq rzp tvc
wat: gzg jkh pmj mwk klr
eym: kxe mmd jcv uhn
ftp: cyn cqf bly foa drr nqg zrl
avk: dfp drd ivc
qpa: rse elc
ekv: cat atd zxn qol
gau: nhr gfh zfw
hjq: jvk lhy mmb bmm wws zwh
hnm: xvh nwj qwo czw qda vnz gja def
dbx: lff wqr bzv tef
nqb: bme aqb xwx xfs pco
wti: kez nkw qcj hyf irt ddz ick ixu ezt
zoy: clt
tdd: jpg gtz
prt: hxc aco ssf umf
wex: xme nov
apl: hyr chm ouj ijc bgo tvi naa pte
erx: zwz esj amv
tww: wta wdw gex xgw
bos: rzr mup xmq tpq
wmn: dxq uwm vkp dlg dad igo fcg
zjn: ycn sih mgj
xba: gwn ysk
tse: trs zaf lih
nrv: cya bot
sww: eie
cpz: ewt ozo huo zqz
sde: jou iun bbb guj bvc htr
oth: bex goi ydm zln
bmp: luy ljr rtv
uvy: ppn int bjf
dad: cij izy wxa
qmo: rfj uhw sxt ren yko
opw: cro sbx ihd ake
djp: aga idf asr pqh tef cga ysk ope ato
fof: gad ycd oxr ugh uyj
ijc: piz rop pcz apl gmx kpk
prm: bvy nos yry oyd int fzh eop oql xok pao nat
kwt: ixm nls uxj dsv ude vyt
nwj: hnm mss sye evo ezu
std: yqw zwz pit xxv
nbz: oxi jbx
zte: oub
ypz: egt kpc uwg kro inm krj wrr rcr
khp: nvs mpm
rde: mtu igo ajv hll
lhy: wjn egt ten zoy yuq uoc
tnn: sna bwi wdf rlk qbc mqf ynb uik
aoo: sls zqc vcd
jmc: kow cbo lpe xnj zsy vsc hdw
xnj: yua suy grt pao asl
iky: iyh
ihd: rac opw fud
acs: otc cmu
rzl: bmi unq
vlt: bze bpc coi hoy zjb cat
qnw: tdq zsz yix
myz: elc eri qqi jag qtq
ndl: zsl ahh pse oyy stl ysh
vbw: xgl abx fge cjl uvw tvc
xgl: zsy vem fdd vbw qgn cwo glw jfu
vyt: hyf web bxm uvk pzg kwt
hbs: ldd plg qaa
mnq: dxb
nkh: tue kpk
ibb: ypu jek czd ykp puk wsg qcj
uvw: vfm fhv ttw
kpn: utf klr lnv iun
ycd: zap eeu trs hxo
egv: ivc
ftz: hft xka xpi oyj rog meg vwi
xew: dro qqi oyz cjl zsy nrv guw dwe
ryv: chx iix zcb yqw bot yqi
wps: eeo zti
ztf: uvy
sae: roz
mms: ztm suy iyp ubj
ovk: hyr xac cuf kdz fyi pco xuf
dkd: bfy xme sto ord flk jtg mdg hoo fhz qgs
wwe: pay tsk gla ktt ena sih sak yvi
fyi: piy meg tsc xuf
pco: nqb hkn
cdc: jzk tjz
amb: dtk sae
zud: asl mgj
fis: zdo onr lpp
qkx: cya gbs jek
aql: xqo dsi
xey: ird cyu
piy: vav jul cqp fyi vqe bda
xwx: nqb hif
trs: fdb udk
dbc: pnb kud dnm wwe nka psa gpx
jkh: ihw elm qqu
gkm: ato zow
adh: vja fsj cle fcy gtx puk
bgu: cry uys czw gtx fzc glr
ajh: wtg fof zuq ztd mgh hdo lkf mnq
qwx: nwm gfo
kyu: ita ujv jmv wun qjy mss nqo
dcw: cjv roe
flp: nap bjc ygm
qia: plz jxi usb pct pao fzc
zdh: khh aly ioa
dsh: hyp qoc lzd
axh: zxo uaf ibh bdj qsd
vmz: ipe lnt
jsb: jiu bze wlb rwl
hvt: ttj gkd qbi
gpb: jiv qoc qgs
bej: trv ood fdc hpn
vfm: tgl bme uxj qjy tkh uvw mkz awt
xrq: hyy uik mby cox sto
paf: qmq
czd: gyx hyr rvi ezu
ihw: ayh utf hfv cyu jkh wlb pxp
cbo: jmc toh syy xut taw fdv vap
yad: ajv
vfw: har zdc pmj kub
xsl: nee
khu: cyn flv qme zdj jhs bmp zry uij cga jiu
gkd: hvt tww izu meg qfe ynu qeu sqw xgl udk quc vpl
cwo: jpe rvi kmp
blr: zti wek ykl
qno: tei znp pju
ord: irf emw
hxi: nbd fsp
vbj: fxj keu dqo aga adq
dsn: suo bwi
tfw: ufr aeu zid dpa ulx xkj klt
ydb: vnu qrt kyq euc jsv
imh: ihg xis ocp qgs
ope: djp
qhi: mjn zti lnv cte
zti: wps owa zuh uvc oat
vzr: zcb
hom: gnl
rrh: zqc owe hyp vjj zwe pxp ptq
gdf: yvi ury mpm vgk uhy
qqu: aco zqz ysk stl jdq sto nvz jkh jys
kic: bvl ppn qti wcf uez fsj yqv ggn
sff: qno ubj tfj cjl hpd zln tsk
qck: sxi mmb ato yuk
yva: zme khh fjl glw
xax: djp hht ism lfz clt mby sdw qiy
tci: ijy seo chx dsv dzh
zxf: rjr bzv rll
xxv: wme vly std rxc wqq zsy xnj lkq
ono: fgm wbk sww stb lfy ekb
kta: nzf flv ufr sou
lkw: jpg jzk ezo gkm ruu ztl ejn vlt
onu: yls xgo
tvh: kwe voq
utf: kpn ruu ocq ihw sou
sov: ezt vnu
sij: jtg ojh ddi ocr kzz
nya: itr gtx qda pzg xok qtq
wej: qpx
inq: xaj rxr
gah: uxp zdh dzh piz duf npm mdo cry czz qwr fzv wta
gbs: otc qbi tdv
ahh: ard jff ndl
wfm: kje bdc
veh: gur arr kub pqh ojh
dpt: qes pfj qqw mtu ezo avx gjf jhs dto lsp
qfz: ykp vpl qda kvu ull
zjb: bvc ygm cpf
jpq: mwd otc lin sak cuf
jwx: mod vwd bgj eik
lhs: tfr iun uyr
tyo: btw arr bka qes ofr nap ymt udg flp
atd: zgq coi bjc irf ekv
zbx: bly zti vwx kxe gnl ihn bei ulx akd eeo
glw: epv zzq hmx
wvh: drr nvw iqd mfh jkh
oru: tnn wmn njg qnw nvz xrn mmb dmy
dbs: dfu zdo
rlk: tnn poz
yvi: ktf jlp gdf jcy sxy tww xxr uys lnt
djr: wtg rfj zcb
drr: jop igo dxg
vhg: cgq ucq jfw mgj
wah: fms oqp wlb flk mjn kxc puz ysh
hkq: arr vhj
kzz: ufr vev sij uix ard qmd
udw: zap
vec: dpa lku kch yie cox whv vjs
xeq: pit egu nos yci
aem: vjb qfe
fws: qpx zlz
neu: zuq aql dml
bot: mdo jsh ryv snf
zbs: vjs ayh vfo
amt: wek jfl vme
vkv: owa avx wkp suo ivc ity
fab: vbq xot sia pwd
mpm: pte
ktf: wip nos inv
web: pxt
cij: sos dxq dad eqg sna
vqe: yko ijo ygv
awz: fhl
arr: hkq veh tyo obk
bow: ocq inq wuk bvc
rmk: pai vcd
xxr: sbh vnu dro
hux: hww wgo
eyq: ych ihn jzk inm btw wej
bpb: azh jdq oyy vev ifv rlk
uyr: igp cgz obk
wws: amt taa xgs bly fil fms
bhf: pay
ncp: zne yqw quc
soa: bda scn ggn sae oif nwm ctd zne
rtv: zxf wjn hht qmd
qjy: gyx kyu vfm idc
guw: hmd gms fdd dbk zys rop
nfi: tdq suk ygu ptj mdg
pgr: zme ogd fgm qpa qsd
ofr: gpb etr rtw tyo ual dsh
aga: vbj yhe hyy
mdy: wwb klt rzr
sjy: qol paa cph hkj szc fle nbg
tzh: dml zfw usz xpi ipm klm jsh
elx: zys szq kud wqq
abx: fjl hqt zws mjg vbw
ols: yie pai cus rcr cdp qvw xde
uhn: vfo goh gvs qoe
jop: jiv xmk
vcu: onu ibh vwi ctd dwe cdl wvn pxt efw sso lkf ahv awt
uka: uls dsj tvc cen fge gbs ooe
uvh: qmq zdj izv yfe jff smu
xso: inm zah vjj sjy
suk: txd sde egt
ocp: egw vaj jop imh
gaa: mdo rhq rfj
egh: zwz awz xxo tse yaj
rse: vsl vaq evw inv czd rij qpa czz cuf scn
efn: zuz lsh tdd ird ztk
xsy: btt ncl zid igy fil mdf sde klt jfl zuh
dpz: ggo erj dmo yry snf qyr
lwj: fjf owe cga
zfw: wme tzh gau
ewo: lpp tdv ryt ubj byy jgv bra mjg haa
kxq: veh dqo tdd kfb
ayh: ual vfw zbs rbs yix uyr ihw zhb
btq: hpd ypu jfo
fgm: eik ufq hvy fne mwu ein pgr xut jag ssq
yed: ubj
nqg: wej hkq ftp
xye: hww
zcp: jqu seo cmu ryt jba
yix: ayh xgj zxf
qqw: klg xgs flk
jes: wip lih yko nwm hif okv gla xgo nrv
npq: nzf flk tmm ljr zah zuh kua
jdq: zbg bpb dxq mtu qnw qzs qqu dto
pxp: rrh ihw
pvb: snf kow
nnl: vsl ybn
loi: ezt
hmx: qdm pmc xoo eie ecd tsr byy glw
jsh: wip bot lfy
lkx: htu bvc zxn fyh
izv: uvh nil wjn glm
tkk: vja tbv
zao: wey rxc
yls: ctd dsj onu kuj khp kjt aci cxq hft
cqp: piy jfu mrx zdo oth uvy mqb hoc
mwd: web ena jpq kvu
wlb: iug lzi
rvi: hhq cwo pvb
pct: duf zpn qia ood
wsn: uoc
nbd: ndq mdo rqt eia dwe hxi wqq cnb
qbd: prm pmc glr ouj ibh nei tgt int fds
cmu: bgo txf zcp int ddb acs
icy: pwd igp
zrl: cph guj
twt: odj dnm lad qpa xac izh
gwn: hoy ufr xba oqp
sfh: qdb qbp lkf
bhx: gyx cgq psa gms iqp gsp ipe zdh bgj
rcp: gvs
lth: uwg kwc
tdx: zik qgs zge imh fab akd ogl
huo: cpz
jmq: ymt xjj svn jyw ncw wdf tmm xvm
tgj: dqo eiq xmf udg fvx huu bei
kro: pfe ypz uoa eiq son
cro: aem lad opw onr syy ddb cle bhf
rwy: lff hkj siy xis
bfl: ude btq ptv int vjb
lbq: ejw fyh uvc vfo smz
hoy: bos siy owe cvn gwn vlt flp
rhr: khd ukh gps ddz jlp mss
hrb: nas pax fjf
cnb: nzh oxi jsv kdz lpp ude
vjb: jbx ogd aem lzh yko bfl wsg
lwi: uoa rwy kxc xey
pnd: uyu jcy vfm glr akl
hyu: tpf ato pax abg fbo
cgb: ldh ruu cpf
xgs: wws qqw eye
uoa: cte zwh xde njv lwi kro xow vfo xre
oxk: yhe eoc ato
lff: rwy gsy dbx kpn oqe cgb zjb xzw qfo xdu zgq cly
vpa: pdx akf les vnz xpi wme
stl: ncw ird clu
wvn: afs zxl tdv doi yuj
kwe: hqu tvh siy zlz
fcy: xlt
jgv: tdo eie ucq
emw: xba rcu ztk zrl nil ihg ord zsl qmy tvq bzv
meg: ftz ake lue
hsk: inz ezg iyp lfy yay
cel: rxo fud vwj fne def ous pte
wcr: gzi lpu ztd
idc: qjy zzq ydb sxt std
rxc: bej nkh zao inr zfq xxv qkz hyf
ttj: hvt qfz mun vyc
nbg: sjy bhk
owa: vkv fho
xjj: luy css bbz qol zzo son
chw: wqq iyu hye fdb dsi
xgc: wwv
bzv: flp lku nee xgg tur zxf lie klg dbx qmq jfk
ijo: jqu ufw vqe
vsc: jmc jba rri kje zpn
kqa: ycl scn saz ypr
zow: hda pta djo jmi
nwm: ggn qwx ykh byy elc sdg
dyx: ijy izu
rhq: uez ztf gbx gaa ucq
wur: kez avb eik wgz gex
krj: qqw srd cte iun son zbg
mss: nwj
zhb: ymt
ydy: trv bxm
jqu: hqt hdw ijo usz akf
tdv: gbs
jfk: cfa ysb pax
qiy: qmy
vog: cjv ihg
adu: sxi ogl cat keu cjv cgz zoy eeo
lbr: yuj xwx qda dsi
bpc: cap foa zva
rpb: uyj ick lnb pct lfy
oel: mmb eqg utf kro
egw: goh unq zhg abp vxt ocp
wjn: ifb izv
fzc: jfw fkp bgu wwi qyr qkx izx fhv qia wip
ycl: pwp mod kqa xka vrh qdp
hll: rde mzx srd
svd: lht hft iyp fzh gtx
eia: nbd gxh iid sqw
iix: rjk anq jfu jro gsp hoc
ctt: aly zaf idc cxq wdw euc dxi lpu
wqr: jtg whv xgj wkp dbx
rov: iyp pcz hix
lfy: ono
sos: etr pzq pdg ezo cij mwk hoo qlb
ggo: qtq sww xya lbh iky qwx bgo
adq: vbj ezo
rri: xpg zud mko zzq fud
puk: ibb quc
keu: gur zys fhz kpc
ozo: mdg cpz cpf ocq drd
bra: ewo lzh bhf ipe
iuy: jop huu npq ndb fil ddf cfa ual svn
xya: uui hmd dsi
euc: ydb lfy mrx
vem: eop zxl tue xgl hyr oyz gxh hkn lzh ssq bex vja
srd: huo qme hll gvv wqr nlv wat
nka: xpi fgm ovp wxo fkp gsp zcb aci qvj
vin: guw eln uno prp khh bgo ixm ddz
uvc: lbq edk gsy rpt akd
rcr: ols suo djo
tmm: flk nov hll npq
zme: bit evw lbh pgr gaa djr yva oyz iid qbd hix
gla: bwp fcy aqb vnz fkp
pmj: cjv
cgz: uyr xba cyu
xuf: qqi elc elx fyi
dpa: vec wrr tfw
xdu: igo qlb lff
chx: bot enq mqb tci
txf: aud cmu
vpl: hqw ccb
wey: trs zao oyd fyi
aos: cxq hmq
nrg: ehu mne
cdl: ygd khh xgc jay grt
qgn: zxo ijo int
yie: wrr rzr rot mdy wne
cly: gtz lff
rot: yie nil jvk hwh sum
uvk: vyt vwd nfj pdo byy
kmp: cwo qkz uvk hvy vup syy ccb
pqh: grb wxa mby djp
mco: hme aoo luy zks utf tur
oyz: zme sbh jgu mpm
fhv: uxj onr uvw bit bvy
zlz: xme
dsy: dlt pse hqu
ocy: nas pfj wws svn jod egv
ysk: cyn xba uqx fbo dad qnw
mko: rri nyq sxy
qli: dao ekb aqb vnv
xpi: twn vpa aud rld
jou: dgu zmh ity roe pdg xgs gsn sde
tue: vem vhg nkh vqy xkz ixu izh hyf
tgl: duf azl
yaj: erj vbw cow ykh gex egh
pwp: sye amb vyt jjw ycl llb mmy nrv ijc irt def fsj
goi: egn
rch: xqo sox
lie: bzv hkj
kmu: uom ptl
hlc: nee zon eqg
kje: wgo mun
fzv: amv
cmt: jcy lkf sih
hmq: ydm doi aos pau ury wha
klg: bzv ihg non phu qqw dgu bow
prp: qeu wdw lkq vin
iyp: hsk dxb
yuj: egn lbr hoc
lzm: lak
hye: esj wme elx lpu
ncl: iqj bly cvn ysh cne xsy
mca: eoc
aci: jpf qgy yyi yls ctd
ihy: jco ehu vhw
mrx: jgu kuj iky
mdg: dkd nfi yhp xqt huu ozo
klz: dxi bxm syy
zdj: mnn khu egv
lop: sih vnp cou
uez: yci krt kic nat
vev: kub ygu
hxc: uix uyk
hqt: abx zud dpz erj zrh cuf gbs jqu
yhs: pyk vkp qvw cly ihn xah
llj: zxo tkk wnu prp hpd
gee: nsq ysy bbb
tjc: jgg bwi bfy
ecd: qti pco gfh ggo
uyk: goh mkf hxc jgg fsg aiy nfr mfh
cvn: txd
afs: wqq khd vyc jdz pdx wvn ous
phc: lnt tpe ksj
cgp: wnw ico mca qiy sli lgw
odj: twt oql zfw srz otp
ykp: ibb
ggn: inr nwm fhl nvh cmu ddb soa wwi vgk jlr krt kic zdh
fds: wix quc sgm rfj qli
ssf: zqc awk amt roe
vqy: izx lkf kjt tue ksb ovp mfb
izx: xgc vqy qdm
zln: gps sov rvi bdc zte
duk: wzm ein jgu wme
zqz: jod hwh mqu emf ygu zgl cpz
efw: ygk jjw
zid: tfw
nsq: hyy rtf nzf hmg gee glt clt uix
nvz: pta oru rxk
ndb: pbb
flk: ndo
fef: rvi idv fdv dvj xgo pct
jag: fgm tzt myz
suu: eep pdg rcp mcn jsb xey
yqv: mnq noe qcj ujv
xkz: dmo lnb
ydm: oth iyu eia hif
wnw: cgp
dpp: aiy eym jpg mjn
ous: cel zla zlx ksb imn
ygv: vly
lfz: oyy ljr zbx sli gwn wrr fms xmq
aot: iay mhq gfh xme fab
sak: ixm tsk saz mwd wwe
bgj: jro uls fud pxt
shs: foa sxi iuj egw sia oel iqi
bgl: iqp ucq uls
iqd: wvh mzx lil iim vib
jlr: ggn qwr
tdo: ipe dmo jpe jgv
oyd: prm egd kpk
seo: chm tci ssq
ptl: cga
cqv: qdp eop
qfe: krt bit
mnn: rxk ird
whg: uno dro
gtx: onr
xmk: jop dzn zhb gzg
ezo: adq lkw
mrr: qmd
ybn: nnl bgl gpx zfq ncp
iqi: jcv tdf
qeu: gkd vca prp iow
taw: tzh lvj qia fjl cbo wzm fis fsp
vsl: zud noe wnu nnl tgl
csx: iqj hjy
eye: zva xgs
vwi: gds dck ftz ury
xmg: ezu asl soa grt yva
puz: azh
ygm: zjb zsl
dvj: jsv tfj zws qcj
inr: qgn nvs ggn yqw ykp
fsg: rrh fle asr aab
cte: krj ifb ykl
gdv: atd uqx rtf jrw fcg akd
lzd: qgq yoh fhz
tzb: vpa foe jek epv ekb ksb lkq
jpf: ycn ixu gex udw ijo egn eeu xfs
azh: puz xaj ykl yad cjf yun bpb
kfb: xmb kxq
hql: dfp ysy glt xjj vjs
iid: yqi kow hxo zme eia dbk
zks: gnl gsy mco
smu: uvh yuk fms
ctv: den cus yuq svn edk
vap: lvb nyq emx dca tse awt lcr loi toh lnb sak
rll: xev ktu adq bka wib zxf cus rcp
wdf: jmq yhp htu
okh: dmo vnu tbv std ypr
xvm: ehu fao iug wmk cqf qbc
btj: zbr tvs vxt
nhr: oaw gau hhq ena ygv
oqp: gnl ihn yhe
sdn: fzc ewo pte egn qya qow
dca: zws jsv itr
nak: onu jfw pco wti utj wme zrp lvj erx
dsv: kwt nls roz
ehu: nrg jkq xvm pxp
qwr: tkh ovp xwx hbo jlr
egt: kch nef kfb suk
rxr: ihy dxq inq
gds: iix idc ktt vwi lbh vca yeo
lqz: jro dvj zwz qvj sbh qpa wcr gzi
zrs: ezu tfj frg jro eeu
aja: mmb ndb udg ihn zry rzl ozo haw
udk: sbl qdb twn
cle: cro wea sbx uaf dml cow apl pau
pte: apl avb mpm jxi
sdw: xax bxt nfr lwi yfe zbr
eik: emx doi szq wur
mkf: qmq pax uyk
ouj: sso
ewt: tmj uld hoy nzf vjs cpz
haa: gyx ewo wip
fge: uka
hyi: ipm wix whg
ual: drd hme emf
bhk: cat ncw nbg ocr ldd nxi vwx
jhs: fej
bwi: awk tjc dsn vqb qaa
jcl: xpg snf
gpx: otc onr ybn dbc itr
kwi: toq neb lzm glm cne sjy vme
oql: wea akf fyi fsj odj snf
gyx: glr uys lht haa zwz czd nei xuf qjy
inm: xso yih eyq paf
rld: xpi snf ddz toh itr aud gyz
pyk: ztg yhs
tef: ldk ocq dbx djp vib
ztk: emw yhe efn
jod: zqz iuj fho zbs ocy xrn jcv fej aco
ztg: jzk kch suk pyk hkj nxi veh voq hfv xlc
jco: uoc hom kch ocq ihy kke
yhp: plg mzx wdf
lnt: xye vmz txf phc
jjw: efw gau vkb vqe lop usz nwj
sdg: pdx xye
flv: goh cpf jtg siy
aab: zzo wws ocp rcr ope
kud: bwp elx dml
rlc: bfy kdo gvs
avf: rxk ten
rij: wun erx mkz qno
xah: ysh
irt: rzp gmx gau nos
bvy: prm czl
vhj: dxq poz hkq cap aiy wnw ptq
fmu: tyg mro
ymt: jyw poz hwh mdf zhb
ojh: sls vkp
kdz: cnb
hyr: vem nwm wtg ovk apl bjb czd emx lad
nfr: xds uyk
vwj: oif ezt lpu hxo lad jfo
mup: yoh aeu
ldk: nef kdf xdu asr
dfi: vgk qdm
ddb: cmu yeo
wnu: vsl qyr hbo dsj
eng: gnl zks bbd lzi kdf
uyu: gad hpd pnd hye
xut: cbo ipm xgo wha
goh: egw
eop: ktt wwv vem
ulx: ifb ptj wwb pxp wsn mzx
gad: vfo fof egd wsg asl
zwe: poh xow lak zge poz rwl
ibt: ukh vnp oxi tpe wur
mqb: otp doi cqp sov
dqh: cen qdb sxt vrh ita wfm
lih: dsj glr akf zlx lop tse
nat: uez svc air inz
otp: odj cry mqb fcy xxo epv
hfv: lzm ztg ocr xdu
bka: tyo rll
xmq: btt wqr hkj ifh gee
mos: sgq cjv tud ogl
sna: cij qoc
jcv: jod iqi
iov: oxr jta hif ibh
znp: qno aci glw nck jfw egu rhq onu
ztm: fne qcj
czw: boz xqo
tmy: hkn akl hmd
mqu: zqz srt zdj zge ysb ztl
iay: hrb oqe nbg qck fil
pdg: jou suu lgw tdq uwm bbz
jgu: oyz duk mrx
cox: mcn xrq hkj mby lth
qoe: avx vfd clu pwd
air: gbs jta uzw nat nqb jay kje
fzj: kam ptq tud mqu pov
xrn: mdd hoo izy igp
ajv: cjf bku kxc yhe yad ynb rde
plg: mhq rgu hbs iug yhp cne jff
tsc: hhq nvs hdo xwi fyi phc hxi
qyr: cya wnu lvb
uqx: igo ysk jiv
zsz: xqh zon gpq
etr: qoc bka ofr vwx
nde: gms kun xac hux plz jba vja yci
dto: jdq ihp voq
har: jkq yja zge rmk vfw
sbl: ztd ynu rup udk kks yqv amb azl
hwd: yeo std hpd
ixm: kwt sak
dmv: wne dgu
pju: qno icb fjl qtq lvb
zaf: ctt tse bra atj
ruu: lkw mos cgb kpc awk
zxl: vem
yzb: lku toq rmk lbq pfe ywt
fcg: wmn vqb fhz
mwu: mgp tkh fgm dtk uno qdp ncp
uzr: bmi gjf
uls: bgj bgl
tdq: pdg fcg
yci: nde xeq uez
sye: avb nwj hxi nvh pwp bit
uzw: air iov qti icb nvs
piz: gah xac arc kpk
sox: doi tkk ude xoz oif uyu rch ijy ojq
zwh: fej eym uoa
zap: qbi lnt yvi jcy udw ycd
btw: vfd ymt hml eyq dpa vjj coi wex
xcs: igp bmm zry zoy dsn
lue: hdo
pai: obu fbw
qyh: gfh ckq xoo ogd qya nnl hif
dro: ykh uys
pmc: ipm nbz
hxo: eop
srz: odj cya
nap: skt hle whv wps
ekb: ono nls
ihn: zbx yhs ope eyq aja oqp
jmi: zow igv zrl hjy xgg tur
dxq: rxr jdq
yhe: ztk oqp ywt oxk
zry: dcw xcs aja
qcj: vkb
zqh: meg xgc cmt srz vwd
ocq: utf jco
gyz: rld xkz wbk xgw ena
xwi: tsc ahv nqo xeq
pao: prm qia xnj
dck: vwi arc ouj
kxc: ztb lwi dmv dlt ajv vxt dsy wah
rxk: mnn nvz pax xrq avf suo vaj
qes: gyu yih jgf bjc lkx
haw: qgs obk
sto: dkd xrq
ihp: wsn ddi dto vhw lwj
yfe: nbg hle mfh ojh
lpp: zuq cnb
jkq: btt mwk lzi har tyg mjn ehu oel
fdv: ihd fef snf
eoc: mca ifh ncl wjn ayj htr oxk rlc nxi
zws: dvj
qmq: mkf wuk uik glt paf uvh wex
tdh: vib bka nja puz zik yuk rde wek
xoz: jqu
soz: fjf zsl vxt
kow: jmc bdc pvb
hif: ydm qyh ujv
wne: pcs wkp bku hjz yie cdp dmv
uhy: hbo fsp qti
jys: uwm ico rjr qmd eye hbs rlk ayh
inz: idv aly hsk ioa tsk nat
bso: wbk kjt mod iyh
dim: rpt yih ehu fms aga htr
tsr: hmx bej cro uqi yyi imn
qqi: xew ttw elc myz jcy kyq xuf
lpu: hye ctt
iqc: pnb ryt zys ssq oub jay otc
hpn: hux czz fau bej
ysb: mqu tyg gsy ity
den: qpx jiv adq mfh sgq zti ctv
rzp: iqc nqv asu hhq lzh bjf jgv irt
zsl: emw soz tud ygm
bmm: uwm wxa xcs
gmx: ijc rzo ull irt int ren
pit: std
xde: uoa mne kdf
dxi: klz kks ckq xkz
kxe: ztb xah eym ywt
kpk: mkz oyd ijc
hqw: pgr vpl jmv ees qsd bjb wix ogd jgu
izu: gkd dyx ufq
uno: whg rop jcy dsj tkh
wxo: nka
kke: tdd ayj dmy hda paa
zah: xso npq kdo umf kmu bei ych
fsp: enq eop hxi taw tet
lku: vec hht pfe dzn yzb
fne: lvj jro ztm odj bjf xfs fgm
siv: dfp sli yxc zbs hyp
frg: zlx pau mjg ydy
nck: pzt wha kez
rqt: zys pcz
eeo: wps adu bxt
udg: aja luy hjy
sxi: zbg adu
ena: wwe gyz
zrp: xpg puk siz
gvv: xzw kua gkm dsh
gnl: avf aee wib hom eng csx zks oqp
def: pwp amv eik gxh dyx fjl
foa: ftp cap bpc eyh
mtu: jyw iim jdq
zva: bpc ztk eye egv djo avk
atj: tgg hkn xfs hvy
iel: whv ztl okq hxc
jiv: gpb den
sgm: evw ykh jmv iky bra bme zte
nzh: bxm rvi
edk: suo uvc xgj
nyy: zon ejw jkq atd jgf kpc mcn fzj
cjl: ktt vbw jpe
yay: bhf wbk qtq pvb
mjg: frg ewo ipe
tei: utj fzv qno vrh ezg qbp mdo
quc: gkd lpe ncp
sxt: qda zuq
gbx: rhq sck iow vsl vpa llb ees ipr
ufq: izu aos
eso: mhx
akf: loi bhf jqu
cga: djp lhs uix aoo khu ptl lwj
dlt: kxc dsy
kyq: dnm mgp gfo udk ixu qqi
rup: pcz
wxa: bmm css vqb
xme: aot zlz srt wex dkd unq
ada: lzd gee ddf edk xsl hll njv
zmh: jou noj ddi gsn aee abg
hvy: hdw kmp
eqg: iun dlt rcp
qaa: hbs xcs jzk aoo bwi hqu
xzw: lff obk qiy gvv
xfs: fne eeu qdb nqb atj
ccb: mgp dck mun avb lcr vpl
xot: vbq fab
vfd: btw qoe ysb dpa
azl: mfb tgl ood
nei: xlt gyx hdo syy xhb tdo
ztb: zuh bly xgg
nvs: uzw qgy khp inr zsy
xka: ftz
ueg: zks uqx roe ezq bmi ykl
oqe: aiy tmm iay sia tdx ezq vib xqt zdc fbo oxk
lin: jpq pcz lzh mss dsi hmd
lsh: efn tvs cyu
bei: xkj wxa irf qnt
cat: ekv bhk
nef: lil egt etr ldk sgq
izh: fdb dxi nyq vqe
vjj: xso dlg btw rrh
ndo: flk bfy xot imh zgl
nfj: uxp bso bgj uvk fis axh sih
kun: chz nde lcr foe mko vav
xgj: edk wjn idf
ssq: zte fgm
tpf: hyu hrb
les: vpa ukh ojq dnm saz rac
hyf: vja jlp
cow: cle ygk fdc lue
twn: fdb udk xwx xpi qwx
mkz: xlt
xmb: kfb yja ncw nsq xgj
ato: djp gkm xvm oxk jso ezq hyu qck
bbb: eso
ptv: czw fkp ozt lbh
hoo: xrn tur fyh
utt: clt rgu paa xsl
fil: xsy wws srt
cne: kwi hkq ncl
vwd: ita dyx zqh uvk
jiu: fhz mup jyw ifv ptl
wea: oql klz
pay: lvj pdn nhr wim bhf wey
vnu: xxr nvh bda zfq jpe fdd ydb sov okh yci
