qwb: mop dnf ire ejr hwz xck
zcr: tgf gnf
egp: qxr igw mef mhd tas
srv: ivx cxm env
waq: vbf juu kno xpd avd wwi ubt qfs yyl
net: dnf hdy sie
hgc: aco afj dyg hdf vqk duh fnu mub kks
pdl: gyz cqn okn aui xrc vws nkx gzq onx
tmz: qmg drq nyu bfo jky wmb ild
yms: est wwu
eaf: awv umk fig izc ljh weg yhx
sns: seb fay cld ubr vka hdn aui
txq: npo loi cyl
daa: xki tpf ghm nng kzr
ubr: ubn lbf ybd ulc erz dze rgx sns jgk ydo wjh wze vhw
ukx: bia loq fki oew gqu lxw ilu
zcl: bmc jyn bar zre kiv gxl
pbo: vql uch kov tnh pmm yjw ttj huz msd bla
npw: bca pww
mjy: ybu
xar: ptl cpp loi eop mop evm gdq xgi erz
akm: qlz cov nse ixn kyf rpa
xyc: itj rgo ndq rtn rvn yhx
npo: eno vox jnt zou dwb cut gke txq cgj cxm pkr
tvf: tpl nvy fgw
hcd: oos
kdz: fxc tkq
tgv: wky gdj aar ery
zib: mub ljz ugq
kyo: pbq swv xej tsj
quv: dyq sgt
grg: qbf otg hes xdo
rgg: jjy eca yqx sjg rpa sqw
gix: trg
mdv: jft gkx aro
uao: jwx lmo aqi miw npw dct mui
yvs: jrb sms wad
gxl: oad jvu
xqu: klj
onx: qou mrv ttn aso not
ilx: dds kdz fay jjt ery zjp
xdz: bvi vrl
kvm: xfi gnf lgq qxr bnb ckx jfj seb
joj: roe dom oxh usz yjd
idj: lix yzw aqb
dbr: vyb ygv wqt hyd reo
oxm: nob
uvp: tfz edr eop zoe wfz
yuo: idt hve
ufz: bvt fsq ama sen fpf kvc cow xal
xza: vvu kon xki
fec: foj jjw ghm
ylq: fqo yqx vzw
rxt: wev aep vrx aei ckh
kvh: fyt hrf jmw
gay: fvi pts eno cti tie jzl irt
tmm: zjm bap dku xri jsm qsx
lau: idi jgb wos xog yna gja hza lxt
oso: qtr eko yci dom
ehw: pst gvh
wxo: lum kcw mju qnv asg ygt ncm
zdx: mxz cfw ken
iuq: zjp mfr taf jvu yxt env vbf
uyc: rkc qlt qba fku
lgo: wzy fbk xmo
ztz: pzy bca reo pwj qpy
jmw: mbj jqw tku
uwo: pjp nkx bjz cfm juu oew
nrc: tpf geg jdj
lml: fks olw qns tur
oep: oex czp
ffx: nlo lnr
tbe: awf swf uzy
ryp: hhw piy mox ges yix dsc hyd azs ixn
rul: xej
hqe: sjc iiy qka ezh tpe zoe
ljf: bhv lkg sdg nyn aqs
dke: esm tas dds rfo fck giy
gkn: yux ylq ujc ddn flu wrr cov
fwd: fig krx twv phh xmv uzy poi tfq
kwo: cgx ngq
dot: xmv hrf dfu yms
cgc: kyj aei
vmc: svn
qlr: wwy vpy uuj xep pkf lzp adn noh
sie: fwg irt
azn: pvc khs seu
ilm: rou yih
oaj: cgj lca aze wix ggx
qdi: alp cya tte jqw cbn xer yrs
bwy: ujc opw hgx qvj
yzx: kcz geg khs jjw
mfg: dxp lmo jzi hoa
nng: kjt daa ldi ywv kwf env gdw geo
jfb: hao zen
gvo: rgz dga itj
fwg: ffw zpv mrv klx sie
vdo: bqy nih bhj gkc cxm gdq vhi sqx
eop: uvp tou nsp cgc vcf
giy: meq pqe iqc kyj
ert: kce ozk cgw wad
rsk: udo eca lgr ycl qlz
kcr: xck aep zjn
ipk: dau vsz dbr fzo
jlz: rjf fwg dss hxn
bdl: txa xki qsm xkx
ovu: xvv fuu ciy yrs xep yuj owt aqs npw dru
aje: ung roh
ivq: uhb wff qsx rnt tjq
rcu: ipk ver jkm
qlt: dup tte
nhw: dzl boa fkk
eqn: swr lsd tpe ldi wfz qcu fho ttj
crb: xuf lcg buc erb lgr lkn
pnf: nfu wrr wwl lla
lua: dze wge elt kfu okz taf
yeo: uvj sbh
yzw: dwu okn idj evj yvw
xfg: mef ttn zus
kjd: lpo ofo
sgt: wrw jky quv dlt egc
vxm: lxk dcd zzf qal
bbh: usj ftf knb rhh cxx
xdv: pcz bqt
koq: jzl hzq
ttk: zfu
jwe: wzx ale hsa
cow: wbh cti gcn let izv bop nzs
pkr: oeu lsd cbz goe jjw npo zmz
gdq: txa ooe vdo jrq
cpk: iqa zou tpf
ybd: okz spf acc bge iap
gdm: cti eom tnt ysx eii
dod: qvm ebm clp gcp lxz ryp
kcq: dku cyw mod
dgp: nhs dqt lqu
elh: tfz gke xck nhj ajz
dwi: ldi vox
wge: avd nju ajz fbg tlv
dss: yjw aep
psp: qsx ebm fkk nxv dbh jdi bbu kee
tpe: eqn osb
usj: cba bbh ert lkg akm hhw oxm
yxk: rtc vox vws
yig: grw ner lkg qvd yoz ttz
mfr: ptz iuq
bmz: qvd lhe vnu
zus: vdt pvo xfg alb
hti: dkx lzd ppn aiu
zff: bvm mdz sdg
oht: srv mop ueh ggc mfp yvt loi tlu tpf gdw
rni: hve yoj ftf zpr ckw mdz uxp dga gpl dsc glk lae vct
xfq: cib lfx iue ljz rot
arg: dut kzz gnu hrf fbw dru rqb
tfz: bts uvp msb
ilr: hlf ipn
cfw: riu wad zdx
znd: ldi
dga: pbg ljz gkx hgx
oym: cba ngj spt
bgv: sgq zgj lmx ghm sbh
msx: ibw kcw abp ggf oss nvy qdo
gjq: ild rvn
qez: nih tay ofo
evd: axb tou ubt usa
epr: dbs xib
joe: bqy lua xak sjc ixx xpd iqa hcf nnu qqg cvq
aep: acc vws hao
kvc: hdn juw yxx ufz
azs: jos hgx gkl
gzq: rga ufz vox hhi acc jtq
qaw: gmi jpd fpc
vau: qbn gxl yjw
yxi: acx
srr: htw pxy
vrx: mhk kwi rxt ffz
csl: zpz uxr ueh sbf obi
fhs: aei ugy hcf jgb jgk
dsg: tgi uwt mqy iid eli tmz qiy nyn pwj zal
cld: sns tou csl
cvq: lix xfp sew
zen: avd jfb sjc
oqa: nji
jli: qlz
mrv: yiu onx
bvt: ufz
lpz: czp pay
hza: xls mhk lau
rpa: rgg zyo
aco: gsf nbe ebq avu hgc jev dhg
bbu: gbb cft psp aiu
qlz: jli bri atw
ken: zdx nfu lae sra piy
dqq: sma cvq elt ion juo oyv
ewt: aov rgh uof cfu grw nhw isn paw
ptk: rtc jfb pqe rdx wjb ztk
kfz: itd oeg rou ugq omy
utc: phh gsf
tlz: hqx vei rou zfb whr
hdn: sns
qvt: ztp rdj pqc zro zff ylq ura
pbu: ner kcq
jgk: bqw hlf
vsz: xvv ucr vyb gbb laj ipk
ueh: oht yis
zzz: spu rwh
gyz: pdl tnh
ybi: bhj nwn snj wak
gnu: uzj ygv mmx ihz anq pyf
tpf: ffw daa bqw nrc cpk qfo
ibw: utc eff ics jln msx hzo lqb
jky: sgt quv zxe yoj roh
nkx: pdl uwo pvo
ncf: kse hlo mod
klj: xqu wqt rkc cdm uwk
pvg: meq vnk bla lca wme
cvw: wzp ogb
bnb: qxr zre ejr kvm ffz bbi kwi
rwh: mxn rcb
nep: qvd kzz
yvw: lup bia goe qka wme eln
vhw: ubr oqm zbl jlz obi gdw
kwf: cvt nng sxr
mll: lun xya cld ejw
eli: dbh lbd trg
sxr: kwf kou cqr
yxx: tnh vka
khs: wky jov azn
xfc: vpy hlo dsg uzy ruo yxi wty lcq yus
ngj: pyt lmw oym
zgj: bgv ooe
adn: ags ybu dct
kwi: bug vrx ksf
ztp: qvt ylp cqz zal qdn
jnd: qol wpr jgo
ybu: cww ljz qod mjy mdp bah adn weg gbm
xdo: msp jft yhx moj oym jkc grg
msp: xdo zrf ebq bwy dwe rov
mpu: wze tlu hwz aqb
oty: yjw geg fya ivx
zbf: sms fzi iwq mrn
rcm: lup ghh zkt
hrf: dot fdw
fho: krv igw kdz seb gns lzn dww cqh zrp
mop: tkq jqa gdm kon xar qwb ejw
hbl: qfs nsj gom oep sxr oex jns
aux: nyn kbf
pou: qez gjs fck vty zbl ahj vnk uht gxg jce
tcg: run wak rpi rkp shh boa
krv: vws big
cbz: juo jgo vka gja jsc
lqj: opw wks uld
jzi: rsk mfg dbr ebq laj mfi kwh
let: cow crk azn elf vmy yiu hrs
pks: dde tet kjb ycp gkt avd
lcq: qdo srr ylj wrr nyu nfb
yoz: krx yig nyf
ijk: vmy bia pbe
cgj: oaj elf jgb
rga: uwo qfs xne gek wos dwu mdi cxm
wie: oxd yuo rqb cgx kqa
kzr: juw ion daa mvl khe
bla: zbl jju sgq
vvi: zhg vrt irt ggx
zlc: fpf
kcu: hve zdx dnh rpi rgo
bov: ukm bem gxs qvx jwe spt
eca: zhp rgg
tqt: ddh lla kwo
zxe: vlp jky nep jpd elz rsk nyf fos
hbn: oum kqa klu
gpe: lzd lgr ess
uwk: jrb wbg vnu vlk ixm
dzc: geo lua usz gyz vvi tas vzm zwf vxm
vgy: tmd buf ivq zal mli nbe ovl
adv: wbg kxa bwy
gxf: zbr zyq gbm krx kvh wil reo idt uxp
kcz: hrs wlz big yzx
mgj: sra fks xqy
sqw: rgg pyt sdw lak
ssm: gtd hdf zrf iex
evm: xar bsp gbd tkd
vnk: pvg
tie: zts iyi zho mrv
uxs: msd
nwb: blk qol ulz cbz aar ulc cly bqt
tvx: rjf cqh yyl dwu czp zjp
kks: eff otl iak
xlz: lxp tmd bca abp utc
rij: ztp asg iue hdf tsq udo ale jbh
ags: bmo qnv yuj kee rat fzo fly xrs adn
fwx: gqu nzs vhi cbz hbl zpv lee pfl etf yfs fxc
clp: khq dod
ion: aqb dqq jpw dnf kzr szc mrk
swf: tbe emp mfg rvt itj bah dru ild
guj: cdm tgg udk ewt udo lbd xgg
qba: uyc ixm
wil: yoi sep kwh aje
swa: mju jav zib
gcp: wsn pbg
ofo: kjd qez jgc cgf
dhg: zyq trg ypk mjm ckw dlt dot sqj ehb
cvt: lpo zrp kwf
lzp: qlr laj zfu
pvc: msa tkd reg sjc azn rat bpa
cny: fgc rtn lto cng tgi vsz vpy
eqt: evj zpv ppe
zwf: dzc xki oqm xrn bbq xrc eom
nxs: lun bsp fgt wbh sgq gnf mhk
gjs: kiv
krx: gxf yor yoz gjq fwd fdw ked
pnv: naw lqj tqt
yna: idi hzl enm wbh fxn lau aar igi
ahe: foy ovl ekk nea mjy wbg tmm spu
pei: hdy kzf dwu
blk: uly
ets: bzl aku sye fgw xqu zvb pqc tgt
xib: hoa
klx: ump tnh pjp ire
pjp: bjc ixx lss enm zjn vau lqu klx qbn wam
kqa: sye hbn rno wie wak awp yus
xvj: fyt zgk jrd weg fjo qiy ehb rmm tca rpi idt
lnf: bca ess tsq
alp: jra zfb qdi wwy vaf lrl ylq zpr
gsf: idt vct
yep: kvr tlu eqt dzc ijk smg yxx iqa
whr: uuj vmc sdg sdw aqs
ouz: tqt rkp sdw uxx cft khq dyg sss ruh
oeg: xkf zxy atw kfz
hyl: rvs otg jdc
jbp: qqb cgw tvf eer
mqk: ivq hdf olw ylj xkf jme ehb
qrk: lpo bqt
isn: rhw dbh ewt
lmx: uvj tay
lhe: vzw tna qsf opw
dau: poi xjk bfo rgo ddh vaf ipk oxm
kfm: igi lst
wwi: bvt ejr
pcz: xdv seu mvk eil alb
vrt: mef obd evj fpf for vvi qbs
btf: wbg hud ylp jft
zpv: wam zqf
qvm: dod tjq ckw dsc
cxz: cfw hvt
mhk: nxs xbg vql bhj zkt hza vrx
dku: qfg kcq hcd swa kzz tmm
bar: pts wjb
svn: otl rvt zal vmc
vas: sdz ddb
moj: kyf pfq tsj
aqb: cyl ybi xwq mpu not idj
tte: tof brr umk qdi qlt
gpa: bbi kon irr pay sew
nnu: cti cld rjf not joe
ixf: ivx xwq
aso: klp onx row zyb
iex: piy ssm
lee: qtr pex usz
fdw: cov cyw
sma: rmp dqq oeu
weg: ycq dot cfw elc jpd eaf
fna: sss mgj dwe ppn jit rmx
gcn: jdj tnt pbe okn fay
hqu: ilm dbh ixz flu cyw wxo lkn
nhs: vnk fpf xfp zou dgp qtr kcd
yyk: tnh jov gab dcd xne eno
pay: pjl wjl bge cqh lpz tgf
sra: lak unz bap xqu kse ken mgj ahr
acs: bap
ygi: sdw gkx ckb xox lml
bfy: run xuf isn
lgg: rdj xsq nvy zal
irr: vxi dde cqr
jbv: cxu ppa bts
sfu: wem nsp ffw avq dqt
tmv: pog fxn lxk ixf goe vmr loq obi lfa
bmo: lcg hvt dcj
bel: rhd ldb alc hfi wge fki juu
xrn: wfz rqv nki aui mhd mrk zwf aar
rqj: xmo xsr txa yvi yxk kjt dwi pmm fki
lum: uxp poi rgz tut
for: vrt tlu
tlu: mpu qfo for
ild: qqb mox gjq hdc pxy lla
xpw: nbu yis kjb smg hzl oqa yvi
bed: yza hvt dwe rhw
lmf: fhj rgh
hol: cut xbm
vmh: crs cie
aro: xsq mjm mdv jos
ewl: mhd
dcu: jpd egv bbu pvw oym
yfs: sen zkt sie blk zre koq
jns: kno zmz hfi crs jce
iyr: qol xal zkt ove
xfi: kvm gvh ooe
evj: duf eqt
geg: oad fhk
jbj: fpc pqi
zrn: bjz rtc vqu lvy yzw ilx bop gkt qrk ldi cyl
mvk: cvt fgt edr him
hxn: cgj spf pei jlz gjs hza
ggc: mrv mhd gja qfo ozc
maw: abp rhw
zou: kon wkq nhs cpk mfr
rpi: xvj fbx tgt
wlz: umb igw fer wvh
bym: mfr rfo smg cmi kfm
sqx: jov iem cwc
cdt: gkl gmi hko
goe: sxi hwz pkr
qod: bxp jbh wie ylp yuo
ycl: kbf ihj gtd
drq: tyx vgp acx gpl qea hve tmz
ckw: lml aux qvm jqw
lqb: cft qod fqo tsj jkm zjm xlz wvb mdv otg moj
yvi: szp okz pbe dmw
qxr: bnb dnf tot
piy: ken iex uwt ryp rcb
zzf: ulc ilr
wrw: hhw gkx qho sgt fbw lmo yyz
ejr: qwb
aar: iqc tgv xfp dbu
xne: zho qfs jvu eku cvt
qho: wrw anq bmo
xbg: kiv gnf
nea: dbs sax ahr uof
zoe: lvy uvp gbd seu
eoa: cgw
gqu: wsc tkq ukx twq xbm
ess: wad gpe lnf
cyw: hqu fdw lev
uly: ilu blk ery
hlm: naw eyp zfu tna jrd uvs
obd: gwi vrt swr xpd tkd dds rgx ijk ahj
zjn: xki hdn pjp znd keo
sti: ylh iiy ubn
xbm: hyh hol ghh
fqu: jgk gns xck mef
ozo: fjo nqs
lxw: bnh wjb rfo
yrq: dhh bwt obp oeg
gbm: dot vpy olw
igr: nyu uyc xsq bps aqs vsc
anq: lbd rvn ffx fzi xmv
rnt: lfu lmw jmp kxa
ekk: wsn sep
dcj: sdw idt cxx bmo dxp
afj: hgc wqt yly ung guj
elz: tut piy ftf uzj
oqq: qbs
paw: gar ewt jrd
fzi: xqy anq lkg
lnn: rhd ztk dqt wvh lgb zqf
ugq: zib vlp
rhh: htw vyb fgc bbh
reo: atw dbr fpc xgg ztz
vtu: gns zpz bug sfy yjw eko
qbn: lfa hlf kfu
wic: ymv lnn nzs ffw tnh hyh lss acc
bwt: wrr
seu: gwo azn
ump: tet zre gas szq klx oqq
ovl: yoi yyz sjg jbj
mbg: kom tmi ddh
avo: szq bwk klp jce
jdi: rvs btk
iwq: vsc egv zbf dbs
xuw: dwu fay rjq bug
ozk: mjm
hlo: omy ncf zro dut sqj xgg lkg
jpd: qaw qdo weg zxe
tsj: wzx piy pbu
owt: ckb naw lao ggf nfu wsn tmo wma
aqj: jyn jti fhk ozc fst
oqm: vhw dag bge wpd
pqi: jos gjq jbj
grw: kbc ewt obp awf rtn nhw yig ixn ert otl
hxm: nfu nwh idp wsd bqg pqc qvd
ire: ulz jfj
bps: rov qdo xri dku
fpc: qaw hes
edp: poc vvi rdx oew txw smg
ppe: jnt wix fsq bba
ucr: lgn yss fly vsz aro hve
dds: lbf ilx gcg
ksk: fhj gpe cft jqw aqs sjg
qjv: tew nse aku jiu dhh
izc: iir tgt mrn mox gpl
yci: uin sbf oso vnk
wff: ewu gzm miw
wnc: ssm hcd rul ixz gmi
yux: mxz gkn
xyi: ncy qbp
jjt: evj dmw hdn ilx reg wss
knb: jra jwx ovl tmi ggf ovc bbh
srz: lqj wna bhv baf ylq yix uzj wmb
zbl: pou bla fya
fkk: fuu ypk qjz
gns: fqu jfj xkx mpu vtu
pog: rug ohw hlf yvi yjd pvg
naw: ner nxv jcy lcm hlm cya ucr pnv
ldb: gas vhi lpz
ffw: xck mhd sfu iuz lzn tpf mll fwg
vbt: odg gnf dgp etf dst
gbb: lfx fig efe bbu vsz opw yih
lzn: fho ffw
ytv: omk hfi nsz bbi fya ppa
rno: kqa yxi mjm qhi
gja: krv xyx gdj cbz msa zkm
reg: pvc vdt
ipn: gnf ilr sgq
osb: tnt ixf zkt yci kcd iap uxr tpe
dbs: nea ldl udk iwq epr ayb bmz hes
glk: bzl epr
yza: ypk unn ozo uiv ncf
tkd: obd hsl evm
ghh: jov zhg dde xbm kjb mgg kzf rcm idm
yqr: abj rrt hdy ozc wjl ewl
kzf: xal yxt ghh jfj lzn
xgi: sgq nsj yis fki
tca: jev pnv jiu ipk hyd yih
wsd: usj rhw ked kom pyt riu lfx
mbj: fuu ued vmc hsa hud jmw mmx vct
cbn: rkp qdi rvn ehb wqt
tyx: mfi omy fkk drq ura bzl htw
jzl: koq gdw
aui: xrn pdl ylh bqw fhk
lnr: unz ddb ggf vgp ffx uvs itj fig
mvl: kzr ffc qls
ooe: ncy xfi zgj
zhc: xlz nob efe wwy zxe qqb lgn ftf
lgn: fpc hgx
oky: lau eku qka ymv wky fay
zpr: rni alp dkx kee mxn
gdw: oht nsp jzl
zxy: oeg fzo acx mxn
kbf: cib ttz
zts: faw qfo
zqf: juz wbr lnn zpv ghm snj
bpa: pvc yqo nki cpd
gar: paw bah vmc zro
eku: oky ysx tou
wwl: mli uiv pnf fdw
seb: fho erz usa okv azn
igw: wlz cmi zxj cpd ipn
ale: pbg fku jwe zxh
djm: bug ssx
mfp: khe gyi hao umb ahj ksf
gwi: lbf cie hao sxi obd ysl lgb nwn
iym: maw nec ruh jjy yrq rnt ovc ldl rhh ked buc kbf
wzy: qol uxr fck lgo
zyq: sgw gxf tvf pnv
yqo: xsr cpp bpa
jtq: wge gzq yjd bpa
kon: xza zou xfp gpa
vws: krv pdl rhd
rmm: bxp tje jkm iir dcu dod
ckx: wzy ghz fer loq
zyo: rpa tna mxz gzm ngq tnw
boa: hsa nhw
ciy: lfr iid
dqt: sfu dgp kyj pvg umb kjy lnn ckh oyv
lkg: ljf fzi mox
vmg: yjw ulz bqt yxt yjd hdy cqh ydo
sss: ouz oss nep qba
dag: lix oqm wpd
trg: eli sep gix
tkq: fya dna kdz
dww: kja
uof: ewt wff paw yoz xox
uvs: gcp rli zyq jdc tgi mdv
zrj: ncf quv lbd bzl wmb fcc
vbf: waq fay ilu big
eln: qal vvi oyv kcr
zmz: jns rmp pkr
iqa: vvu yep cqr jnt him cpk idm
nhj: vhi tgv oex sbh yjw
hgx: bwy
tmi: mbg rva
lrl: ggf xjk
pmm: net pbo rqj
zhp: xep kwo uzk cgx xrs dzl eca jln
wfz: xrn kjd zgj
bug: kwi djm nsp vtu yqo xuw
hko: jli tlz nec cdt yoj
vlk: chi ayb sdz uwk ygv nyn
aqi: lxz uao
bdt: pyf xkf sms
fbw: maw ylj jdi tmo
khe: wjh mdi mfp
idp: nwh iue qhi lgn fpc
ejw: mll mop
kjy: ckh xck
dom: oso joj cpd jyn
shh: olw yoj lmw
tnt: nji osb gcn
kce: zfu lev ert uxx vrl gmv gtd
twq: ret qmd enm jdj fya fqu gqu msb hyh
gtd: kce zgk sdz omy ssm acs ycl
vzw: mkg omh vlk tbe ylq lhe
uvj: lmx yeo ywv lca yfs unt qal
jpw: ion seu ogb geo
mju: ndq wxo bfo emp jos swa cng
wpr: jnd kzf ffc fpf
bvi: brc ver gzm cxz xdz
ygt: pyt uzy nqs aiu
ckb: oos vqk mre
cya: twv tvf iwq ets rat
bxp: qbf tmi qod rmm cxz dsg pqr trg fcc
awp: kqa ebm
bzl: zrj tyx
oxd: zdl
ptz: csl dej yxx mfr zmz
sow: ljz
ruh: ouz sdg gqy msx yqx
bzb: egq wzx ovc
ffc: lgq oew qfr
zxh: ale vrb zvb opw bfy
wbg: btf adv trg iid
zbr: aje rtn ycq nse bmz jli gxf
szq: ryh jnd hzl avo ump xfp vty
kmp: xcb
wss: olx eln bjz juw geo jqa
gas: ump enm hcf
qol: wzy osk iyr sti roe jnd iiy geg
xak: not hyh ueh nsz
irt: gay pjl fst
ylh: pju fmr rfo xkx qbp
lxk: lau vxm wos wev
jit: wqt pxy jsm
xmv: dot
pfq: pbq jei lqt est ttz moj eff
vqk: pkf pzy ckb
yrs: yyz mrn
gom: cpd kiv
wmb: zrj
htw: vnu tvf srr wwu mdp
oad: kyj axb gxl hdn geg
yyz: bse cqz ovl yrs lae wrw dbr
lzd: wwy gpe svn noh ypk kyf
fhk: row
qls: wjb eko zqf ysl
efe: npw jud bfy
smg: qbs oex tln xpw lgq bym alb
xfp: nhs jrq aar
dct: wks uao uzj adn hzo ges uhb idp
dup: brr qlt fzo rat vnu cng wpf gpe
uch: pbo
lgr: rsk gpe hvt phv dnh buf fgc
brr: tte pyf
jvu: vqu gxl iuq rug
eno: yyk bqw xbg
jrb: zbf jit uwk akm kwh
ahr: hve phv nea fbx
ozc: zkm qmd ggc
txw: ksf jce fxn iyi
mdz: rni nec zff pqi udk yhx
tnw: oos yor zyo pxy
iqc: odg nih pqe qsm qwb kvr giy
jxg: ptk nsz fck vmh ilr jax ckx
ens: fvi sxi aqj eku
bwk: iuz pjl huz avo pks unt
env: iuq rcm srv
qpy: zjm opw awp atw ukm qnv ztz guj bcu lqt
bbq: vwr sma gkt ppa wze cyl zwf
nji: iem wpd oqa tnt
qqb: ild zhc
jsc: bmi nju
nfb: jiu aqi ace lcq lrl bwt
mef: vrt
bfo: tmz yix ixz
vyb: xqy cqa mpc
uxx: kce bvm qsf xgg ppn rmx qdi vpe
gke: elh kja ehw ery uln kou uly
khq: rbg clp ung ace
awf: rvs ypk zjm tbe grw gmv pww ciy utc
cng: ver cny nyf vaf mju
rau: mkp wky nkx pfl dst fbk erz ama joj
lcg: tje rtn crb
enm: yna gas
bqt: nwb qrk
bmi: nih ffc ama ggx jsc hao mhd
gkx: mdv bhv dga vaf
rou: kfz
ulz: ire vmg mef
unn: laj uuj rgo
vqu: odg jvu klx uxs
tew: dfu guy qjv
vct: tur mbj egq vrl gsf
hve: drq lzp yuo kcu
rdj: vnu jpd lgg brc cgx
nfu: owt pnf yus
fhj: ksk weg qlz ffu ilm mkg yuj gkn adn lmf
fcc: rli bxp iex epr
lgq: kvm wgc
pbg: tur dga lto bdt lmf gcp
vfr: ptk ubn zla irr wev lgb
ysl: nsj lfa obi roe
abp: xvv tku maw msx nhw xlz
gxg: qxa dcd
lbc: egc wku wrr brr hes jrd ebq gix
zjp: ilx qxa oqa
laj: jzi cfw foy unn
bmc: wgc gdw bjc hlf
bvm: hqx jav zff oxm udo
txa: gdq szp oso bdl giy ili
iwr: rkp xqy xgg gqy
bjc: zla dst
xjk: jei eer iys lrl cxx
qou: ano loq omk elf
cbx: qns ayb zvb wpf sjg lak
hhi: uin zzf gzq lun
swr: obd soj mgg
fgw: ihj xdz
vty: xmo qbp
pzy: wwy pwj vrl ztz mpc
lwr: jnr lix nzs wgc qka
oyv: lzn lst fgt xog eln
cpd: dom erz huz gom zjp
hud: yms sqj
gru: tgg pqc ekk jme lfr
chi: vlk
zyb: nwz aso lpo cie zlc gnf
lbf: elf ubr evj ano gxl dds eii kja
mre: vgp tgt iid egq ckb mui wmb
ypk: zzz yza awf fkk jbp
ajz: elh crs tot wge evd
izv: xyx vix gab cow ehw
hhw: xdz ryp sms
pqr: bxp tca nwh aok oss
xmo: rqj vty dna
ftf: elz ttk bbh rni
rtn: cny lcg bvi
tgi: cny rli dsg iar rot
jrq: gdq fvi obd rqv tpf yci gkc xfp gay oky
dru: jiu jbh
hyd: dbr zql
efi: wkq net uvp kjd uxr ptk
mxz: nwc yux zdx sdg
baf: kcq wrr bdt srz lak lfr yly ylq
qcu: klp lst big sfy sbf meq
qal: cly bge uvj ffc
nyu: sqw rva
wwu: twv yms ace
avd: ppe pks djm zen ssx wge
zxj: keo daa oxh
kjt: rqj fmr juz dej quj fvi dnf jpw
lcm: naw fjo swa uwt jev ura gca vzw
juu: zkm nsz wkq abj uwo tgv
kee: zpr udo
vei: iir oos
iid: est
pju: qqg fgm idm vka ylh
yix: oyx nxv
iue: rva xfq
okv: seb yyl jdj
hzq: onx csl kcd lee jce env koq hza vql
ujc: kwe bwy
tnh: pbo yyk yxx big klx wic gyz
fgm: xbm cpk wjb taf abj koq
jnr: qxa bks lix iyi
zkt: rcm osb jsc mhk
zkm: vvu
bsp: evm msb szp nxs iyr nbu fbk sxr cpp
wak: sqj eyp
ddn: gkn qsx sye rhw ner wqd
qns: lml nwh
avu: nlo hgx boa qlt wpf
jdj: xog okv gad
rgh: gqy ewt mqy lmf oxm
xog: wgc
wna: nxv wks tof adv jjy kbf
gek: rga kiv xza oyv
ked: krx
unt: ejr jgk
row: aso pdh xfi uly fhk ylh
ldl: dbs eal yih ylp brr iym
nlo: icf avu ung jli ffx fjo sye
bba: lst ppe yxk eop bug zts
phh: jud bhv utc
vaf: brc miw cng bmo
opw: uzk lqj bwy zxh
xwq: ili ohw aqb vqu ens ixf kfm
dyq: nqs ujc ozo quv
erz: cpd xar ubr
sye: nlo
vka: cbz pju yxx sns
msd: rjq xya uxs
edr: sti uvp iiy rrt foj bqt hol mvk tkd
rat: cya ozk ked dup
vrl: gnw eey xdz
geo: jpw rgx dzc
poc: xfi qez edp fec
buc: dnh crb qjz
yjd: joj jce
eko: qtr
lae: nfb zfb ljh ozy qvx lnf boa
lkn: hqu
gkc: juz vdo avq
lfx: lto gbb ixm rhw swv
sep: wil ekk
mzy: kov
tou: cld evd
elc: hcd guy jei xri est ckb
tmd: xlz zzz jbp eoa zrf
yjw: vtu oty djm dss nhj
cqa: hyl spt phv obp vyb btk
ksf: mfp txw kwi
bst: kvr gyi zcr
uhb: dct adv tcg gsf ybu ivq wnc
vwr: jax ili esm bbq
tjq: uzk omh guy jli ivq qvm
acx: ruo
abj: oex fst yqr tas nji fgm oso juu evm
prc: jyn fik gyi ybi rmp qfr pqe
qut: rhh gsf qho emp ppn gmv eoa nec yoi
xtu: szc yyl zts duf wix
qea: drq maw jft qfg
roe: ysl joj kno rgx
wvh: lnn net fck wlz yzx
fqo: nep xri sdg
uiv: flu wwl yza uwt
tgf: cwc zcr pay
yjq: jov evd taf hwz znd uvp ppa yvt
bts: nbu tfz tpe gbd
sew: gpa
soj: swr elt jnt
qdo: ukm jpd
iap: xsr qez
dna: tkq
sfy: cqh fck vtu zho gjs qcu ywv
cqr: iqa gcg sxr irr
hlf: ilr jgk
yly: afj yxi epr olu
kyj: fec uln giy oad cgc qfr
jkm: bqg eey mjm uuj kyo aiu
pqe: prc xfi iqc hza
kxa: qvx rnt fbx ekk tsq tgt adv
qbp: xyi dej
zro: klu gar
vsc: flu fxo iwq wwu cww bri
est: iid jjy yms rbg pfq
poi: udm
sax: jra ics gkl msp
fto: oll fqo tnw acx otl
obp: otl eli wwu mfi ets cqa yrq
mxn: zxy rwh
bhv: phh gkx wwu
sbf: csl ttn yci cyl lup
sqj: dhg wak
vpy: cny phv laj ttz gbm
cly: gwo dbu fbg ppe xen dde qal qol
gcg: dds cqr
tay: yis wem
igk: fya kon ymv ump alb gjs
kov: wjh mzy pbo
xya: mll ubt axb qbs
mkp: rau jfb cpp ozc snj uin
yxt: lvy vmh iuq
tje: rmm lcg dyy qns
lqu: wkq pjp
gnw: msx ddn vrl duh iak ixz wil mju olu
hsl: cgj tkd lee rjf
keo: vvu zxj sbf lgb roe zjn kdz
umb: rjq
mbe: wze
zho: fmr
tas: egp abj
lst: oyv kfm
qbs: oqq spf xya lpo axb vrt xbm smg
rwa: tgg xmv jzi pwj pnv
fuu: hud egv lqt lcg xuf yrs fzi yor fkk
hyh: xak xbm eom
jwx: hsa tku knb xdo gca qvm
eer: jbp bap lla xjk
hdy: yqr net
sbh: avq bgv
kja: soj vau loq gke dww
bop: enm
rmx: fna lkn srr bov mjy
cfm: meq uwo sxi zrp
jev: mod
sjc: zen lpz hqe oqa
alc: dze wjl fgm wpd vmr fqu cmi bel lqu
cqz: yyz cdt mjy mxn
xvv: abp aku qdn ovu
bnh: msa lxw pdh ixf tmv gas
lmo: spu uao mfg
nvy: msx fbx lgg
wqt: dbr jit klj
fki: obl xgi
rgz: nyu ycq iwr gvo unn
fxc: fwx bts jyn zrp ili kdz
ndq: xyc ycq lkg jrd mju
nex: dds mdi dzc sqx egp dqq oqm xwq
wma: uxp cfu owt mqy poi ale
ura: tyx ngj qvt cya
cfu: wma ewt nbe hsa
nxv: naw atw yix ner qvx gmi
dwb: npo mzy zcr
rgx: hzl roe geo env
idt: gpl gxf xvj gsf
mkg: zbf izc dxp dhh pqc vzw
rvq: qbf gjq mdv tgg sep hoa
zdl: fos dyy oxd
fgc: foy uld
duf: evj wpd ilu rrt qnn
sgq: xgi bla usz zoe nxs ggc ipn bgv dss
cxx: swv bbh
vrb: nob
dnh: lgr vpe rgo
ggf: lrl knb
meq: rhd zhg usz iap
rkp: yxi iwr ouz ztz cbn lak oss
omk: szp fik gvh ytv
hqx: jvr bvm iid yss sdg mmx lcm xdz jpd kse ngq tlz
usa: cwc khe seb
cdm: klj ddb
ywv: nng jnr jgb
klp: qcu hzl aso gdj xdv
ncm: foy cbx pwj qns
lxp: xvv aro lto
iuz: osk
rly: mpc btk tjq zfu fna spu rcb aov
eal: mbg jra ldl yms ljh eer
roh: asg ebm hdf hyl ugq aje
egq: eer vct bzb zff
iwl: aov jft qhi
ohw: eil pvo xwq zho
aov: uwt xkf idt dwe ewt mdp iwl
yss: hko vpe wks azs ura lfu ylp
uht: nju djm ncy cfm
oum: jvr mox hbn ngj brc clp
phv: ahr iex
omh: kom nse flu tmm vzw wak tjq vct
lup: fwg loi rcm yci wme eqt sbf yvw azn
lix: lwr cvq idj jnr dag
rvs: gxs vlp hrf gvo jdi hyl lum
rqv: jrq krv ybd gdm szp ppe
eil: kou ohw
ery: lsd gke hcf tgv
hzl: szq pex xpw
lfa: idm okz qbn
jln: dxp gxs qjz lkg ozy
jyn: wix fxc dom zcl
jju: olx juo bla xfg aso wgc
vix: klp txq bdl vmy fvi izv vtu etf
eyp: qnv jit udk bwt qvx eca wak
lfu: jzf bbh rnt ugq
ghm: zqf
mrn: dyq yrs ugq pww izc zbf bvm
gkl: sax azs tut jiu wvb cdt zvb shh
xrs: hdf foy tna ivq uld qvx ver
kse: roh ngq hqx sra ncf wrw rcu orz qjv pbq
ove: iyr rjq qrk yis xmo ivx
ofw: lgo zrx kon big vbf xpd bvt
wzp: uvj fik dwi cvw ldb ret
not: onx
fvi: vix gay ens
rtc: xfi ksf yxk
wjh: khe kov zkm avo qfo
sdw: zyo ouz sqw
bap: sra azs eer uld acs ayb
dzl: bfo nhw yuo dlt qbf
ezh: gxl jnt hqe zpz hza wos bia
dmw: avq nep dcd
idi: yna bvt rjf
xki: zjn bdl oqq xza daa hcf
qfg: ebq ztz rpa ttz dku iak
kwe: cgx epr aok rcu ujc cgw
uld: xrs bap lqj gzm fgc kcw jbh wqd
jqa: mop wgc uxs gdj ppa
xsq: aro igr
ihz: rcb ess gnu
fig: fwd lnr
sjg: lxz vlp ovl ksk ffu
dbh: vlp psp dsc eli sdw buf pbu lfr isn
gyi: jnd mfp yeo qez bst
ued: ppn mub ttk
xen: jgb fgt hfg taf fbg lau
mdp: fzi
nob: zhc mjm oxm pyt mdz icf eoa vrb
wxw: run qba jdi rbg wrw ges
rdx: ptk
ysx: eku pst vhi lfa gdm vau ukx kfu cti fxn
ylp: btf ztp
ubt: fsq loi xya
mjm: jkm aro rno vrl hyl ozk
crk: yfs jbv wzy ymv dna let xyi kmp
qiy: chi tte
dbu: cly
tlv: olx crs wge
lla: ild jjy tqt
uxr: efi
lpo: zyb qrk cvt vmr zla kjd
fbx: kxa nvy ahr
qfs: hbl xne rga xza
bjz: spf
ung: xmv rqb nlo khq jqw bca aje twv
gca: ver ihz cdm
buf: jsm vgy dbh lgr
lto: lqt pbg cny nec
jmp: ebm poi oxd rul
vcw: rpa mjm nwc fnu pwj
bhj: lpz mhk vdo quj cxu oxh ybi
orz: fbw gqy lev ttk bvm kse
vpe: uxx boa
cyl: zrn oqq sbf
fsq: vdt bbi
qsm: wbr bdl iqc tpe
kjb: xpw zzf hza
sgw: ewu oym
qgq: ubn wfz lzn yeo tkq kvr
dyy: zdl klu
okn: gcn cwc yzw
xkx: him bdl
qvx: eyp mgj lae kxa bov poi
pyt: acs nob vpe wsd ngj rqb ygt sqw lla lcg
foj: jgc edr juw rug ble usz wbh sie for fec wky
crs: tlv vmh
zvb: gkl ets
fnu: bah xsq ycq
tet: nbu sdm
bri: sow chi xsq vsc nwc rul pqi
nyf: zxe yoz cng
xgg: hlo guj uzy iwr
jbh: uld dru
ebu: rkc tfq mfg jsm yix
dnf: qxr qwb zhg
olu: ver yly
oxh: zxj joj tln sti vqu bst bhj
igi: omk kvr ycp uch kfm bop
fbk: rau ixx faw
bse: yyz whr iak tmi vas
cqn: obl pju tgv fmr
ukm: unz bov
jdc: oyx udk uvs gmi fnu hyl
fik: omk prc tnt wzp
xep: jev kyo aok ozy
fck: wvh blk
erb: hko elz jvr wsn crb jsm
zgk: xvj uzk tqt
quj: snj kjt xza aep
cwc: tcb okn usa tgf cgc
xcb: mbe nsj wzp vzm kmp cpk qtr ubt
qnn: fmr
hvt: lnf gvo cfu oll cxz gca bmo lgr zpr
zql: hyd ets cov qhd gbb xox
wsc: czp zrp uch dst kjd ilr gqu
fst: nju vhw ble cti uht zpz srv aqj irt
gwo: cly zts lxk sxr tln seu
eey: vrl rul qvj cqz jkc hhw tew ukm
wkq: zou osb juu efi lqu fqu
asg: msx iak rij jky gzm ics gpl roh jzi
guy: tew epr tjq ewu
wam: zpv bvt eil wjb wme pjp lmx xsr
rmp: wjl prc zmz elf ysl ubt tvx sma svx eqt
iiy: qol sti vvu
qka: tfz oky
mhd: egp seb bmi rxt ewl
rva: chi jzf tmi tte zzz xdz iue nyu rgh
wmi: glk oum ttk ver tqt udm
fyt: vnn kvh ahr xvj qqb oym fos
ugy: fhs sfu
lsd: pkr igw uxs ery tln
uzk: tjq zgk fku ges svn opw xqy
dhh: dut otl qjv
kno: waq
wev: nji qls rxt jnd
nbu: tet bts kfu tot omk
elf: lbf let
gzm: dkx uld
pyf: yuj bdt brr awv gnu
tsq: kxa lnf flu
msb: wjl dej twq tfz bsp
dde: rhd pks not
nwn: gwi
fxn: ysx xmu txw
fjo: xvj lgg ozo nlo zdx xvv cdm
obi: gad ysl eii gdj
fmr: wze msd qnn ylh zho wbr
tfq: fwd fks ffx zrf qmg mpc
mod: jev ngq ncf qvj kcq hud wku
pex: yvt uxr jnr
ver: xrs bvi cng olu rcu gca
jra: vnn knb vnu
nwc: bri mxz
kom: nvy ozy lbd mbg
kut: xbg eko ghm wem xog ixx rga
mli: btk qhi
klu: nwc hbn eca vcv yly dru zro dyy
otg: ddb hyl jcy rsk grg
ffz: osk hfg jgc vrx
kfu: ptk zts nbu qbn hza ysx
fxo: lao noh vsc
oll: hvt cxx xdo qnv pbg
ixn: iwr grw qvj ryp
gbd: bts nkx zoe evm
jgb: jnj olx lau
atw: reo uzj qlz
cov: gkn fdw srr vpe
yuj: xer mqy ovu otl pyf bqg aqi
cba: spu miw jli oym
jie: gab mll uhx dej bia pcz eii
tof: mox tte
jud: phh zrf
aei: cyl okz pbe
iyi: loi tie
nsp: sfu bug
vql: hzq hdn cqn mhk
pjl: lfa pay czp irt
ozy: lae unz kom
nju: ama jsc
bah: nvy oeg uiv fnu gar sdz swf lcg
wku: lbc emp xer jbh mod glk ruo
ygv: vcv qaw dbr gnu
xrc: ttn idj
oss: pqr kwh
wpf: nyf gvo jiu nwc cbx dup vsz fgw
wos: lmx rga lau jnj
mui: mre uao fig wks lao
brc: rdj
iys: aiu foy fdw
fer: kjy nwn ilu cqh lun wlz
eff: vcv ivq pfq ygt sra ljf wzx zhc kks
wem: xls tay sfu mfp rxt kut bar
nec: pbq iym
fks: mgj tfq
kiv: xbg
awv: dyy iex eaf msp bvi pyf
dfu: ihj uuj yrs tew bwt
yvt: yjq oht pex qwb tay
lxt: zrx jfj
bem: jkm hoa bov mox bdt egq tpl
omy: mmx ggf kfz
esm: dbu dke nih for vwr wvh okz lgq avd ggx
kcw: eoa pqi vcw
yor: tgt uuj
iar: lmw qsx cba buf ics tyx tgi ilm xej
fly: ags xib ucr hdf
ymv: igk snj oky
dut: arg dhh rot
wks: mui lqj yss
ljz: ybu xfq sow
aku: ets xvv mmx
ycp: pks jfj nwz
uzj: gnu rot bwy
hdf: rij mqk roh wad ujc
hwz: goe mpu yjq
sxi: cfm ens
wix: ppe jyn ulc
yih: tca ldl jvr
cgw: ert jbp eoa ukm qvm bmz fgw fxo
foy: uvs ued rcu laj fgc xrs ygi wvb egc mdv ncm iys gkx ozo
czp: fki nhj lpz tvx pjl lss oep cvt wsc
itd: hdc kfz ess lry aov
juw: xck vvu
ivx: oty znd sqx srv
ace: khq wwu
pdh: bnh faw vmy etf zgj dmw kcz
dcd: dmw gyi
bqy: vdo zcr ble hyh qxr
ddh: mbg uld rdj jwx hlo tqt
mmx: mbj
lca: ncy kzf pvg ywv srv usa oaj ghz uvj aar
hao: ejw aep jfb gyi bmi kno sdm wpr
big: ens vbf kcz qcu krv tnh
ahj: ohw soj rcm yxx mvl tln obd
bbi: kcd fsq ytv gpa
zrf: tmd jav msp
aze: vxi elt
jsm: buf jit erb
hcf: fhs ery gas xki
xsr: pbo iap qnn rxt yqo iuz pvo
tcb: cqr vrx cwc sxi zus gxg
qfr: yjw yiu zpz prc crs ffc oeu
pwj: ztz vcw pzy dsg svn
sdz: vcv vas yhx gtd
fos: zdl oxd
unz: sra xox itj ukm rou lxp lnr ozy
spu: tnw zzz ahe zib cba spt sow lmo
cgf: evm goe aze
ppn: hti dyg ued fna qut dlt
hoa: tnw xib mfg
oex: wge oep ulz
wsn: phh aje erb gcp lnf xox ekk
mub: hgc acs ued zib ixm gnu
fya: igk ytv
olx: gnf tlv jju wss tkd
mfi: ekk tyx
qvj: mod bwy
odg: ueh rdx pog xen gad iqc vbt
wad: hes ess hdf vmc ert nwh cfw
mpc: rly
ycq: ndq vas fnu vgy fly uxp rgz zbr nwc weg sdz
mrk: xrn hwz geo sti aze sew xpd
spt: kwh isn
rjq: msd lss umb unt xuw
gkt: pks kmp jzl zrp
pvo: yyl kfm
zrp: cvt
ulc: zzf xyi wix cgf nwb jju idi ssx qmd lxt
hes: lbc egc fpc grg buc wad
ncy: nwz xyi gom ooe zre dna nih uht wax
iir: qqb mfi izc vei rmm
nsz: juu xak
ayb: dbs wff
jav: nbe fnu zrf
axb: qbs bhj dww oad lix juu xya wkq qou evd
zla: vfr khe xyx bjc xfi
qmd: twq
gnf: olx kvm zcr ipn xbg
cft: bbu ouz yhx lqb nqs ksk
wky: tgv zlc khs
rhd: lnn wax dde vws xwq bel djm meq nwn
itj: swf xyc gvo dku unz
twv: wwu
ilu: juz ukx gvh fer duf
mqy: khq yms rgh wma fqo bfy izc
ztk: lnn irt csl mbe
szp: yvi omk bsp jqa
eii: gdm sie obi hyh
szc: elt ion xtu nhs sdm
udk: eyp
zjm: qjz rpa icf hko dod tmm lqb
gqy: iwr rgh jos uxp
cpp: bsp xar sen gvh yqo nju kiv
tna: xrs fkk zyo lhe
lbd: zrj anq rqb
ihj: vqk dfu eli fgw ycl sra
vcf: eop nju yqo jax nwn
qsx: rgz ztz ddn psp ivq awv rli
pts: bar cfm mzy hzl
jfj: lxt gns ycp geg ire
vmr: qqg ehw wbr alc evm xuw lpo
xyx: gja jti ptk zla izv
xej: rul uxp
oeu: reg gek sma ybd uln pkr qfr eno
qmg: hzo xer tfq
rqb: ung arg
rug: uch pog eom jvu sew
pqc: hxm lmf gru
ttz: noh fks ner msx kbf yig vpy
xox: ygi lml ftf zql fku
nzs: ejr jfb wic
ret: vvu aui faw gom twq vrt yeo
ghz: bdl xls bar rdx vka xmu
duh: gnw hgc ljz dut
wzx: sms xej twv ozk eff bzb jwe
xal: ufz kzf ggx wjb ubn
pbe: yvi vnk yiu dna ijk sbh aei
okz: lua aei esm lfa jnd
ddb: ftf otg vas spt cdm
dsc: dbh cgx
dyg: ouz gix rov zdl
rhw: isn ukm maw
vdt: zus reg aqj fsq
uzy: xfc ygt nyu tbe xgg rcb
vzm: dzc uhx mvl acc xcb wbr iyr
uuj: yor
vgp: lnr lbd dfu drq
ffu: yuo gmv aku sjg
lgb: ejw vfr
avq: bpa sfu sbh jbv dmw gkc tot
uin: bla iem yci hhi hfg oty
rgo: wrr xyc
wze: fmr oaj ghm ubr mbe mpu
jjy: wna rgg
dwe: bed jmp yqx
osk: ilx qfr jlz ffz tlu iuz kov qol lqu
ewu: wff sgw jpd guy wty tyx
xuf: bfy fuu
vcv: qdo ygv sdz klu
nki: xls vmh gas dej xrn
kou: ama bjc sxr eil faw
zfu: ttk tsq rno kce hlm lzp
pft: hdc ace kks tcg dlt cba ffu
gmi: qaw wnc jdc cdt
ixm: ztz lfx rbg
sen: ufz jov jnj yfs dom
zre: zcl vdt qal zen zrx
xer: yuj yoi qmg qdi
gxs: gpe rvs gmi jln
fzo: hzo dup
ovc: lfu bzb xjk lnf knb iym cww
bca: ztz btk lnf npw
bqw: svx jgk
tmo: pxy vrb wku
rot: tgi jav dut aku
tot: ajz bdl
usz: sgq foj
ano: mvl pdh ugy hol ggc jce lbf qou
xmu: ghz dst fxn ijk uhx
tpl: jjy bem yyz omy psp jme ebm kyo tvf xfq riu
lxz: yih hbn aqi sjg xuf
jme: crb mqk tpl jwe lry bqg zfb
cxu: mzy koq bhj bmc iap jbv fmr qgq mdi qfo qtr
nwh: hxm qns idp uzj jud
vvu: keo zkm ret
hzo: dct fzo lgn reo qmg
bcu: rot ggf lqj vqk wna vsz
oew: edp yiu ffc ukx uhx
run: pww wqd wxw bfy kwe
wty: ewu sqj nyu mpc bzb lak pkf
udo: kee rvt bvm quv rij
fgt: zen idj aze
dej: kjt qbp
hrs: ble pcz fhs kcz yis fvi let daa uhx
qqg: joe zjn lun pju
zrx: gcg lxt zre ofw uvj
hsa: boa pvw jwx jwe maw ylp cfu jvr
ryh: aso lua pvc szq khs gcg irr yyl
aok: xep ihz pvw pqr jei cgx
aiu: bbu hti
elt: qnn soj dqq
snj: mkp zqf qrk quj
kwh: jzi spt
ama: kou nju
jrd: xvj paw
kzz: nep qdn
zpz: oqq csl qfr
gmv: ffu pww qvj
taf: fgm ble xen
jce: jns avo hzq yjd txw uly ano
cie: ogb iiy vmh
loq: ckx gab qou
pxy: jit srr
mdi: khe cxu nex
vmy: let pdh ttj ijk dwb zus hyh
fay: sns
jgo: wjl bge jyn
ogb: cie ycp cvw jpw nkx tfz
qnv: ags bbu aku
rbg: khq ixm yvs wxw btk uof gix est rvt
lev: orz qea rli kce elc njd xlz cyw rkp
sdm: hao oqq wvh tet
wwy: pzy egv alp uwt
him: qgq oaj dww xkx mvk iqa gad
rrt: yqr xfg bjc tot
faw: kou pdh zts fbk fik vox qka
jnt: iqa qfs ppe jnr soj ewl
ckh: mgg rxt dqt kjy hfg
dkx: dbh tur zpr gcp fto vei gzm
nse: utc fxo zbr yux
cib: rov kyo yig kbf iue
alb: pcz qls zus kcd
wbh: nxs xgi cow kcr wjh gwi yna
jjw: yzx qnn fxc fec ugy
wbr: pmm qsm zqf
bge: obl pay
zhg: qnn wlz vvi vnk dnf meq
xkf: jcy
ixx: kut ejr msa joe fbk
svx: lmx wax bqw lgo xls vka mgg wjl quj rmp onx
ggx: vvi oaj
sdg: fqo whr mxz zff ljf nqs
nyn: dsg cxx aux
wpd: nsj dag
ppa: yjq cpk
pst: ufz obl zho aar ehw vty
egc: foy
ngq: hqx
jnj: jgb sen oex wos cvw wwi
wax: ncy ttn
lmw: ekk awp ngj
jzf: lfu tut ujc buc lry rva
pvw: aok anq hsa
ylj: qho fbw mqk kwo pbq
cut: bop ivx hol nsp
cti: nnu gdm ysx
cww: brr ybu vsc
gpl: drq izc rni
ljh: eal iue
tut: cxz mxz lum yux
jcy: otg qjz xkf
uxp: lum gxf gqy xej wma
dst: rau ssx
ssx: ulc dst
jov: sen yjq
pkf: wty wwu vqk hvt qlr mdz
oyx: jdc fna ckw ygt itd iwl yix
btk: bzb bca jdi
jgc: jnr huz
vnu: htw bmz
tgg: ges tbe guj gru lum itd grg qhd lto
ixz: qlt bfo gnw dhh
udm: qmg aqi poi rkc sss dlt wmi bhv
olw: gbm gjq
obl: dbu cqn bjz pei fki bge
yoi: cxx zdx wak xer qjv wad jmw ncm aux wil ovl
vlp: rvs ugq dbh
dxp: kbc ztz
acc: kvr ulz aep
nsj: hbl wpd
kcd: nhs bbi prc ywv
bks: msd mef tlv kjy jnr xmu
xpd: oqa fsq elf gnf
pww: npw mrn jwe
cgx: kwo kwe
rov: uof msp cib dyg srr
sms: zbf bdt
fbg: wge hyh cly
dze: alc lua
lak: baf sqw wty
lun: fer qqg
vox: yxk dcd fhk yis
dlt: udm
ttn: xfg onx
jft: xqu sye ozy iwl xdo btf mdv
yyl: waq bym okv pvo uxr
gad: him odg
vnn: tnw lqt noh jra
pfl: pts rau row xmu fwx
uhx: xmu umb
vhi: nhj fwx
yis: ueh vox xpw
cqh: fho
zal: svn lgg dsg cfu
gvh: ilu xfi
jiu: wpf rtn dru pbu nfb
yqx: dwe
rcb: jkc piy ozk rwh vrb
uln: gke nsz zlc
fpf: nhs zlc vrt wpr
jax: vwr jju vdt gcn
miw: wff cba
mox: oum tof ryp
yhx: mdz cft
ubn: sti xal ubr
qvd: lmw rwh zxe zxh bmz iir crb xib nep yig
vxi: irr hqe wpd kvc zen dag ozc djm aze
tgt: kxa izc yor
cmi: bgv alc omk koq
nbe: vgy kks riu cfu udo jav ihz wqt
ges: ryp
juo: jju cbz jzl
dwu: pei bvt xuw lgq
zfb: alp cov
huz: cpd bbi rfo jgc
ruo: ner fos acx xfc wku uvs zfu bov
msa: nih ixx jyn
mgg: svx swr ckh olx
lry: rgo itd
kvr: iqc igi bst
riu: tpl cfw wsd rcb
gdj: gja obi tgv
yus: ukm ljf nfu zrj hoa ngj
iem: ooe nji lxt sqx fxn uin rjf
ehb: mqk cbn pyf bzl
ydo: owm eom
wqd: ddn npw
uwt: wwy dyg uiv aov piy gix
rjf: jlz nnu cvq idi hsl
hdc: pft itd aro vcv qsf ild dsc yza
fku: uzk ale
qxa: juo ycp ejr gwo ahj zjp jnr eqn gxg
oos: ckb tnw fgc
jti: alb xck gjs aqj ivx
rli: lev fcc
icf: nob uld aqs
lao: fxo tku jei miw
wjl: msb xdv jgo yqr rmp qmd pay
rfo: dke
cxm: okv vdo npo mbe nrc
aqs: ovu igr ksk whr ljf wmb
jvr: erb wff hsa duh
rvt: svn rbg oym
hfi: jns cvw rgx
kbc: grw dxp lkn ayb jdc uwt
ttj: pbo mrv zgj onx cvt
jkc: eey xdo cyw lfr
yoj: rni hko
ner: pbu ddn aux
qtr: oso joe gqu eko dze szp nhs lee
wrr: lbc rgo bwt gkn pnf ryp zdl baf
ebm: gmv awp dod fdw gpl jmp
ili: txa ewl
qbf: grg iys
gab: jie izv oty yci dom fgm gcg loq
ble: dmw taf qfs ogb ixf fbk bqy
rkc: ebu oll uyc klj udm clp
kyf: zff qmg hyd lzd akm moj
spf: hxn ttn kmp bjz
emp: hgx
ebq: qfg hdf aco lbc
idm: ghh wax lfa wos iqa
ptl: ugy pog kfu ydo
owm: lxw gdm ydo znd eln bnh
qsf: vcw uxp jud qhi
eom: zwf gdm
bqg: wqd yuj jme
juz: zqf mgg hao sjc kwi kjt ilu gkc
xck: nsz mbe fqu qwb kjy juw elh
flu: uiv jbj yix tsq
jei: ddb iys xjk vas lao aok
lfr: baf dbh ciy
rvn: cbn xyc gjq
qhi: iwl tof
etf: vbt qmd dwu
xls: fqu wem wam svx nki ghz hza eln jfb enm
pbq: pfq njd ylj zhc kyo nec
wvb: ked wma lmf
qjz: jcy sye fkk buc
hfg: xog ckh bdl tlu
otl: obp rpi svn dhh
qhd: cib olu ale zql
swv: lfx gbm cdt cxx sgw reo
ldi: zrn sfu dwi uht znd eqn
tln: smg sew
lss: xfg pjp czp kcr fxn oaj unt
lvy: ilr yxt vcf zrn zoe wbr let lqu bel
jqw: jmw ksk umk shh ckw awp
nwz: kwf gxl ncy oep tgf pvo odg ycp zyb ghh
xqy: bse mgj fzo fzi iwr vyb fbx bah uwk
wgc: jju xog lgq
bia: ukx ijk yvw
qfo: tpf
jos: azs mju
iak: sow bse
tur: dkx lml pbg vct poi
lqt: lto mxn vnn tqt pfq fuu
umk: eaf vcv efe azs tte
nih: bmi qez iqc gyz msa
noh: ttk chi lzd vnn fxo
tku: abp
yiu: ybi mrv soj
wjb: xza lxw kno qls xal
njd: rkc tje pbq qaw
qdn: kzz xvv isn reo
nqs: ozo cft sdg dyq
ics: ibw asg iar
loi: lup txq oht iyi
wme: yvw wam lup
egv: dcu kwh ljz wwy iwq
xri: tmm iex ycl bps
