nhp: csh jzc tnb hms whd xlq cnh krp rmp
qgf: xnl rql sps
rcx: snq gjc knn
zmd: xwr mfd mnd jrx bjw
cbm: bvv gvq jdr fmh dwv
tmx: cvp fkh
gzr: zjh wcq szx ckf mzd fmz lbx dbm vlr
pvb: qcj plw
bbk: wcm jfr jcc snd nrj cxk
mdd: bcr cww wzd
htz: cts gdn tkc qhj zqr dfb lwc
rps: qzt ndr lpk lsq
ttl: tcm xlk rvh mvb spm qwn thc lpc trz
trp: dlr jzz fkw qgf msn djt
plf: rlk lzp pwm qqp nrw
lhq: cts nfs bml rsn
lwr: pgj trb pwd fcl
mfd: pdh ztc
lrz: lsz fql
dgb: kwr mft bjj
ckf: gzr pdj pmf tfz ghm
btd: cmw rwt pck
bng: cjk kqb pmf flp mcn
zzd: hfq qzt pqb wbc
dtc: xkq flf dsm
dnl: qvg jrx btf rxq nrj
rtb: txq vft qsp fcr
ttx: rmp nml dqd plw jzn fzm jzt srt rzp
fxl: flv pns
pfl: vsp dwv dzq sxj
fzc: sfd tpg qsn
vsm: vbc bht qfk
jdh: nfp sbt cxp pfk jqv hfx wwd
crq: tlj
fhk: nvg gvs rsg mqn
rmn: ddw lvr mlz
qgk: gdn sxc jmf rwb
cxb: vdj cvl gbq zlg
rsn: ztz mgq
szh: bcm bwc rlj
bcm: rwn szh flb dqs bmm hps
lkf: wgz sls bmk xsx
vhd: gvb kvl
fbc: nsx wmn pgh lkm lll dzq
czk: jzb vdj bbp dqt pqg
xvq: gcl bcs bjm
ptk: xtn gpk nvl hlw lqg
fhq: gvh jck tmx kgq qwb
vdc: fzm ppw tsl
dvj: crv ptj svd vbc rlj
clx: fzg fpv gfb dft jhf
lxf: fnp vbv
tdd: vzk bgs rsr lgg cxb pwf lzp bvq clb rqx
mtj: jzn bxm qwf ckj pdl lbt ncx rgb hzd
dsj: csd hbk rnl
lzh: vbb mzw fgj cvl hxr hlj
vbc: qwk dvj mwm vsm
gpg: nzv qvr sjd tpj
dfb: tsl jhz xqc xqx szx wrb
rwt: dhb nvg
vjs: nrw fzj gxf bfp bwb lgg ktw lcb
hml: bnf mpk dlf
rxw: rsg vtx hmc bbp mmv dmv pwf jxb
xdh: xff tvx tdp pdx lpc tkc fcl nsw krb
nnr: vzk mvz jcw nnk fzl
wds: whw jxh nlw bsk qjw
nzv: nzq fmc zqb
lrj: qns bcs nrz gpv grg jzn wcq gcl
lqn: vbj
frd: bgw wtx
npp: vkd pwf mbm wqd kht
gwl: pqb gjv ttb mvq
wfd: xdg bnv nnl
gjm: mkv wcn nwl gpm rbr gzg xsz twt
bvd: jhz
dsb: jrx glq rvc lcb
wcn: pdl hhs mzf
ktf: mlt jmf
nqx: kxb dbm kvt tfz lxx
rvs: knn qvv
vlg: jmh dqs fvf
dlr: jrc trp rsr
hhs: cdt lvr vmm
nvd: qqb lcb tsh dnx lmk
rtp: vvg pld rnn kqx
jwg: fjr dbg vfk
kwc: hdv lkl fhs zqh qrh qfq
gxq: lrd qsv rvs tvl kkq srn
mfp: zbr tkh tkr bhs bps zgg xnm kcd
htb: bzr dbc ccs
nsx: fbc
mwz: csh gjn pdj nzf
zfv: vkp cgj
bbp: czk lqg nsl
fzj: bzj xpq pfx xhm
msd: thc qlc lsj hch vwh zrk tsp kgw fvp
mgz: tzd bth xsg
fqd: fts gfm ttb
lbt: hwp xgl pvb krn
jxd: pts xdg
pkd: lbl gsc
pdk: hlw
hdw: hpz tnv fjx fsl pgj
cdp: ddf qsl lbp xsc
jcp: llp
kdq: hpz hvr crx
rrp: lgd cjz llm
pfj: lmk rvc dpz crq
cnc: nmd zkw hnr zbt hbk
pwt: zbr dln xss
plw: mpc mcs lvt mvx npb pvb
ssz: ntl jpf wzj jqr
nsp: zrh vqr tss
dcn: nsd nqz zzd sbs cnk ddw
vps: kng tpj mlt
btf: gxf vdj jcw gdm fzk rjj zzk
tpr: nvb kvj lrz fwk jmf wnc
hbr: pzb bbs wwh
mvq: klr grp vdd
jcf: rjh
jzx: ckz zbt kbm gdm pqg fnb vqz
kpn: nqr gjc fmz lfm xkv knb
svg: hvb sxc dtr jvg pvb srh qcj vdc
qff: jbh cmg
qcz: bnm ngt
dns: sxk rjr gsp rmn
dfn: xrk nwm pzb mzw jcc zrd ldt fzg nsg
tnb: rzp thc
gwz: dqp khj qwn rcp vnv gvj gjc tlz jmw
pqt: vsc lmt ptm ltl wgf bpj vrk rkp nrr
jhs: fnk vdd tbs
vvj: bzr cxq bxt krp
jzz: rpk zjb ndt
dxj: tbc nhc wnh
bwl: hxr mrk qsd nxq
mks: xgp mfp cmp xmx dbc flp xww twt jtr xvq
gbt: fns qkq pzt cck bxt
ctg: nss tln bmk hvb nxl msg xqh jqm tnv
tbp: qsd fpv gjs grc
wmz: mpc nxf knb dqp spq
jzn: mpv fjx nfl xmz cpg ttx kmj mzf lpj vvq jlq
kxd: tzk wmx
zpd: pxf
zpm: qdj lzx
rpf: cnr
wfc: kxb hnp xqx
xqx: dfb qvj wfc mht xqv ckp wnc djg hdw sbb mkq bnx
zhp: bnf hpd dqt fhs cqv wcv vkd
lsq: rps clb tzb
clb: chf wcr
qzp: vfs hcm csx pqj dtc
dlm: llt ckz txj qsz chq cwq gsb bwl tbc
srt: xkh gjc
hzw: lmk nvg rqv xpv vjb cjz
xsz: wwj vtq
lvl: pdj vvt thc nwl
jmm: lgz dvz tqk vfz
snd: sgw qdp mqc hzm psz
gtm: pwm hsf rnl jkz hpd
gjs: djt tbp fjt
pkl: gzq mcn khk lrf nvb rxd
nwr: kwz lws fvp fmc wrb lvw mvl
fzd: mkt rlj rjl tlj dsq wnj jcw qvb glc
djm: grj zgv xsf hlj qfk vxh znr fjk swc csg
vqx: nlw crs bnm zvq djb cww tln
qsv: sjn cst spm spp prz
smt: kcd tmz wmx grf ckf rzj xww djg
pwl: tqr fql pmb mlt fgg zgf
mrm: wnw dwp tgc dzq
bmn: gxs qpc qcz mgq
lws: zpr cmg vbj
xpv: ktw xlv
qpk: jcf rzj bml kxd ljq
szq: qsz vmb phf lmr zwk
qvz: cpz fts gwl bbz qmk qvg wsf vwj
dwt: jqv dbc fdc crx rvh
cmg: qff
rvm: mpt rnr xtx xbp
kvn: vtd rqj flt txd
kvl: vhd kpq gqt vzt qwf mgs tnb
hzj: sls fwh nhc
fwh: tlz frb fns gmt hzj
ldd: jck rwt mnd
lxp: lnv bzh bkp cnh
qrv: gfj fzz qcg crv pvw nrw dns ksh txq jpf
trl: bfg gdm tqh vbc rjr qqb
wdb: chj jht
fnk: qzc lxs tbs
jcb: vjb fjt wvb qsw zwk
jwh: zmw thc tfz mht
qzg: nlb vsp pqf trc
ksh: bld hsb gfj
dhb: ncw rwt
xdm: fkh flb
gwk: dfp gbn tsg
xnl: qgf gwv xbz klv
rjz: nsg gbk cjz rlj qgl
sxc: sbb
ckg: lkl fdk dtc khs dvz
gvr: grc fnb xxg czk qts cmk bfz
shr: zjk mxh
tcc: nxq lsr zpt vvg wcv nqk gwv
lfg: wkz
rzm: vkd rdm mfq kzm lkl rnl
rnl: rkp dsj
nwm: ltq mkb
hrs: kds czg dns frd wsh scd
qwb: fhq rhq pgv npk cvl ggd zpn
cwq: vrk
vwc: dsb rrc rzb ttb tzq qsj
xqn: swz scc
hst: wsf hlj ndt
qmh: vtd gpv
chl: gfh kpv mth wdl
csh: mwz bhf fwh lrz ttr qwn
lnj: hbk hqf dpz vzb
psp: cdt qvk
qvj: wjs fwk rmq wbd jcr
jqr: kwr ssz vfz fts tfr lmq
xgl: spf scc lbt kvc plj zmw
fzm: wzm ttx
qdv: zcv rvs xss zbr vwh bcs cdc
kvj: nfs xtj bcr xzf smk xdv tpr
qbd: ktc
thc: sdg ttl vgf jwh
mtv: mgr zmv czk csd kqx dsg
qqb: trl dpc
jzb: czk tzd sxj sgw gsb vkd pqb
mpt: vzf rvm nsg qxc bht pck dxj rjl xsc dpz dgq
svr: krk lng nbz pfc htg zzl
xtx: flf
zqj: trh
gbk: rjz flg mhs
plc: bgv cpt
hzp: hps gbq
fmz: gzr kpn
bmb: xdc nnk tqk qrg czg qxc
szx: ngg krn
zpw: shr gsb ntb pvw zvw qrh
gqb: kld tds csn qqb sfd
xpf: pfk krp jxw dhg
wvb: ntb
xlq: hpj
zkw: cnc zjb wzj
jkb: kqq qlc xmt fjh
dvc: znc xww zvq hjs mcn
wcv: jxb lqv xpv zhp dcn fjn
rwj: pqb csg
bwd: qvb xbz
vws: rcz zjb vsg
vdj: sjm czk wzt zvs
tth: zqj pwt zsd lbt bpx rrv rht kcd tbr rqj
rmt: gtt fkq jww vdp zgv lkm
pfz: kgw xdv
fbs: fbp pdp tlh whd hdp rrj zqr xbh zgf dgr
mkd: mxz qlc ktx qvm nlh mdw kpn brp
kqx: mtv qqp wcm
csd: dsj hzx phj hlw zvw
gpk: ptk
lbh: qgj frb hwm rqw lqm jdh gfh hcb
csn: fls nvg gqb nsk
tjd: qww fsd
twq: hkp qww ckb zqj jwh
ghm: gqt cck dwm lqd
qgm: rnh dkx xtn dmd mrm zrd wlt lmq
mcn: jnq dvc bng
hps: hzp bgw bcm
vbv: lbx hhv plj qkz vwh lxf zbr
swl: txd kvt vdz gpg fgt bcr
dbg: gjv vxt nnv bbj
qrg: mdg bmb tgl qkp tcl
wtx: znr qsn dvz
klq: mgz vft nfn znr fzk chf nnr
pdb: ndr lgg tmx wvk pgn bld
prm: kqp jbh qzh lwf
bpj: hlt pqt xnb jbv bcm
ldt: dfn nsx bfg
hlf: nnv hrs xnb kld dpz zpm mws
grk: csn gfm khs
hzf: lzj bcr fmz zzl
krp: qzh vnv vvj xpf plh
zjh: sbb wvz xsz gzr
kqp: pkq nwl qzs fwh twq jsk dkb qls cmp mvl prm
bnv: kxw wgz tfz cwd bcs
snz: prb hsj xqh mdd rzg dwm xbq
vvq: lpc gdt jcf
qxw: gxb pqz zdk
nnk: hbk
bbz: gtt wsc rvc mqc kgf
wkz: pxf npj qvm vvq fjh hsl lfg
hfq: rcz zzd fft pvq vxh nsl nhc btd
mnn: hxx jrp nvt
bjj: dhq ssw
gpv: nxv dqd vtr dbd qmh
dbd: lrf dqd gpv
vtr: fcp xcs qpk mvs gpv pwl cxl pts
lgg: tdd vtw vjs pdb
xff: hmv rzj rmp lnv tjd
plx: qts
ljx: wrb qzh qpc dfd
lrb: mvs qzs vbj lqm
vbj: gxb tnx wtq lws
pqb: jzb rwj zzd cnk lkl dwp gwl qhk frs
kng: wbd vvp nnl dwm htg djb qjw wzd vps
vzk: jzr lpk tdd mfn nnr vjb grj pbm mlz bfz
zdg: txd mpc jrp tnv fjh
pdh: wvk tbj bjr mfd cbw rnh
tgl: bzj zws fpv xzp kql qzg qrg
hzm: flb snd vbc zkz ncp nsk flf pvw zgv sbs
fjt: jcb hcm gjs kpb qzp dvz
hss: qzt kzm rmg ddc dff
gfj: qrv mdg fjn ncp ksh jzz
pqj: jvk rql
rdp: dsr rwj cbt
mjk: wwj hnp dvq
xtn: qgm xjs
ngg: tdx spq tpr szx rmq plq qcc kkq wdp
gdt: hwp mdw ldk vvq cww tbh dvl
nbz: qkb svr
xss: knn pwt
zmh: qmk hst mfr wrc nqz lqg
jfc: mzf mzd mgs ctw jhz
jck: fhq ldd vtw xpq rpf lmf
rnr: flg rdm zgl
zmv: nlb rmg qfq csj sdk
vfg: zbt rwc
fpv: tgl tbp nzl
flt: jrl krj tdp fvr twx kvn xgp nlh mdw
wkd: vmm pss xnm
qgj: pds kbw mvl
xkq: pfm dtc tll fkh tfr fzl
jrx: zmd mfh dnl lmf
lbp: qfk vzb dcl rrp cpt
tbh: wds mpc mlb szx
gsf: vfj zgc pkg grg fvp rfb nkz nxv bqj
lmf: jck rmg xtn kbm mfw jrx zlg
snm: mgs qkz jpj rmp mth wwq
sdg: dtr fzw qff dvl hkm nzv nvt pxf rgp thc
mzw: dfn
mkt: fzd nxq khs
hkm: tvl rqw tnh
mfr: mwm ztc zmh
prb: prz fvm pvl snz zgg
htv: cfw zqh qfq rqv fbj
npb: lvt vdz bcp
jxb: rxw rql qts lwd
xgp: mcj spm
vkp: kjq zfv
jww: grj gqf qth hfp
rgb: wvs rrv mtj
xvn: gxb rxd
hmc: tjc lnj xlg
tbf: glc jcb xsg ttb zfz gqf wbc
qhc: cvl nsk
sjd: gpg jqm jrl
mgl: lsp fcb pjp xlq dmq
nnv: dbg hlf mgr
thj: ckz cbs
fzw: ztz
xzp: mvq cjz nhc gsc crq tgl
rjh: wjs zqc kkq jcf
gfr: hxr fdk wwh fzl hjg cbs ldt
wsf: fqn nsx hst xjl kpb qvz
cjx: nwk hjc
dff: hss vjb fzg
chm: qcg bgs dsr jhs fcr fwt scd
pvq: rlk wvb pfm pxg gmv
wgd: kbp qkq qdg qww
gdw: jhz tzk bgc vqj fcp zcn vlr qhj dtr
xlg: rlv pxg sxk nsl lgg lpk kzg bld hmc
nbr: rmq lng qnb zcv kch mvx
djf: pss vsl nsw tdb jrp
bpx: wzd fvg hpq nkh cdw tth
kwz: mqz nwr qvr tvx
tds: wwh ptm rcl lgz hwk
frb: lbh vcq mxz fwh lnb nmb
dfd: wdp vzt plq lrz hhs qzw ljx
flv: fxl bcr jbt gdl kmp hzd mxz
hwp: gdt lqm lbt nbh
rjj: bzg vbc lbl
pgn: pdk lqv dts pdb lfs mts qsl sgw pfm
pvw: grc rzm dbg zpw nsd hzm
wkf: nwf fsl pdl vzt
jdt: nvg pbm jvp txf wcv mqn brs rkj
rvh: knn tzk ttl
tll: mfw jls dft vmb
rjr: bwd dnx zzk zfz lqv
nrz: tnx nfl spf rzg xdv
dcq: jcd hnr pxg mfq fsj kgf ncp
bmk: lkf xkv
llp: hdv jcp
vsl: cjk hpj djf lqn hnp jxh kzq
lwn: lfc rrg vdk smq hfp qpw djs rlv grp
pxf: rhs tdp zpd wkz mvs
fmt: hbj
tcl: hlt
mwb: spq ksz
bzg: rjj gfm nrj mxh qhk
wcq: lrj
pvf: bgv qxc
hxr: vbt gfr lzh pqf rnr
vjn: xmx
pwf: clx gbg npp rxw nmd
bzp: tmz scc smk jvg crx tsp
mvs: lhq lrb rqw kmp ljq jqv
znp: nvl tpg pnf
pgv: vdp bjw fpv
fts: jqr zkz
fjn: mkg bkn bbj fgj gfj flf
lrp: vfs bvv ltl qnk
fft: lgz swc sbs rpk
hhz: jlr bkn cfs cbs vmb
tts: mtg nrn ncx
spq: vtb mwb
mfh: gdf tzd tpg jrx bwd jbv
dbm: gzr gwb
nrj: bzg bbk cpt xxw
cjz: ncw fhs hzw wpx zpt xzp rrp
flp: vvd srf nml htb bng tln bcp
bvv: lrp cbm mbm
qzc: jzz cbh hfm glc fnk qsp ltq sgw
lqg: zmm wwt vlg ptk
pjp: rlm tgf zjm
dhs: cmw zvp zvt xnp csj
zgg: mth mfp lhc xnm
qkq: gbt hzj wgd qvm bvl xmx
vfj: gsf vwx wvs kmj
xnx: xlk xqv xfn zjh
dgj: lxs mfq fzk frs dnl zsb jvk qdp
lkm: rmt wlt
zjb: lmt kbm
fkw: zdf rrc hnr qdp
lzp: mkg plf
rpk: fhs jzz fft
vsx: krj cdc wkf hrp hdp lxf kbp
glq: bgw tgl kzm wcr msn dsb vnt
knb: wmz kpn jmf jsv
plh: pxc krp tfz vzt gmt
hwk: bbp qdp tds qrf vtx jcx fmt dhq
xxq: cbw rrc nhc rwn
hkp: twq pnh lwg
gwf: zfv tgv ktw xrk
zwk: ggm
zgc: pdl wcn rbr psp jmw mkv
bvf: gvb lrd dkf hhx lhc
jrl: qsx flt sjd tsp
spp: qsv hdp qlv dvc qzh kqb
pkq: kqp vgf nxv fnp xlq
xnp: vkp dhs cjb bzg pzn zvw
gtt: rmt cfw
mwn: qvd tll dhb wml ddw wsf cpz
hjs: hch smk
brp: kfd qlc cmc
bzh: lxp tbh zpd kpv vlr crs mcj
fnb: pwm fmk gvr kxf pgv
ppw: sjd zpr szx wcn njt vdc qgh
lhc: bvf nwf
jht: vvg wdb gqb fzl
jcr: lsp
fsl: hdw rrj nbz wkf
nst: lxx qvm mfj sjn hvb
vvt: ddx gjc
qqv: lqd nwf dvc tbr bwm
qhg: gbm zlg rwc tbp
qzw: tls pxv
wbc: wdb tfr
zsn: hcb kdq
kzq: rxd
vgf: lrj cdw tlz ttw bqt bjs thc
xwg: fzz zkz kld
xdc: bmb bqq bgx
fcw: znr lgd zxr qnk
sdk: pgh
zfz: trc tbf jmh
qxc: pvf dbg jpf ddf
xsf: zmm qth pxj
bcp: npb qwn
vmb: hhz
hjc: lvt kmj npj tsl cjx
wmx: vwh nss hsj mxz trh smt hrp mwz kxd pnh
pgh: qts sdk
mts: vsn thj npp ddw hss dmv cdq
chv: rjj tlj pwc nsm nzl hbr mgr
lqt: vbt bbs qxk rjl dsq
ljq: qpk ktf pfc qns
krb: lvw gxs cxq rmp xzf kbp fvm xdh nwk
gdm: btf rwj
ntb: ksw wvb ldt fgj sps nsp zpw
ptm: fdl pqt djt
twx: ktx zsp
nrw: qzb rsr vjs
kgf: gqf dcq bbz
tdb: djf jpj lhq fvr mwb
dvq: mjk zmw
brv: nmq nkz jgj kmj nzh
xbz: wlv bwd
nsw: xdh
tpj: rph sbt
xqv: qhj xnx lpj
gvj: txd shs zll
djb: vqx gzq csh
vlr: gzr bnx gdw jpj
ggg: kgw jwh zsn mmd pwd wjs cxp rbv
qdg: nzf wgd vjc lrd ngt fsd
nfp: khj dvr phl kxb jdh hwp ttw pkq
xsx: qkb gmt lsz
cvp: tmx hkq hlw rjz
mfw: tll dlr
tvl: gzg bml zjm hkm wjh
nvg: fhk csn hzw
kwp: qlv mlb tdp tvl qcc pbf hrp lpj nqr
zcn: znc lfg lqd xkh lhq rfb
rqb: tck brp jsv nvb ttw qlx qcj
lwc: jxh fcl htz sdt
rqv: wwh hzw kwc hsb pdh htv fkq
hbk: nnk pld dft
tnh: wwj ckb mth hkm bng lfm
drs: wlt mfr
jsk: vzd fbv
xhm: fzj bzl rxq xsp
dtm: qkb xbh zqb wzm bcr dzw
hsj: jgj bcr zqr kzq wmx
rlm: pfc xbq pjp dtr mvx mlh ktm
lvt: hjc npb plw xkh
fhs: kwc dkx rpk
dmd: chf qgm
bgv: gvz xlv hbj plc pvf vvg kpp
vdd: vft csj lll jhs cjb fbc kjq mvq hkj bbj
qth: xsf
lnz: grf wbd spf rgp kpv nwk
lvw: mhh krb nwr lnv lpc dwm
wdn: bjs qzs sdt lpj vcq
cxl: vtr vcq mpv kqb dkf xbh
lkl: ckg
nvl: xtx bld cxk gtm znp ptk mxx
bzj: fkq hst fzj zbm wmn vsn zqz tgl cdp hds
zsb: ldd mcp dgj vnt fpl cbm gbg bvv
vcj: qvk rgs
bnf: kwr hml
nkj: jkb nml crx xsz lvl xqh
bjw: pgv zmd mcc
hcm: hkj kpb qqp wqd jwg pnf
qzt: hss rps sps flg
mcp: zmd wnh rwj ztc
sln: kpv pfz
tsh: lfc dsm mvq vhc tkw wnw
hpj: vsl ckp xlq
jhz: dfb bvd xkv gwb gdw bvf tjx
knn: xss
pss: wdl wkd pdx djf jgj
mfn: lhb tmx chb
mzd: jfc bzr hpm lvs cck qff qvv zqb
fmc: pzk gqz nwr
csg: gpk pnf dpc tjm rwj
grp: hkq vsc pgh rmn kcv mvq pfl xpv zpt
kbw: mlt qgj dqp fcp
zrd: dfn bth cwq ghb
ckj: wgz mtj mdw spf
zsd: tth lxf qcc zqc rfb tsp jcr
sxj: jzb nsm bjr
gkw: flg shz qsn shr klr dkx fmk cdq qsj qbd
lvb: bnf szq gjv xxq kpp dhp
sbt: dhg jdh
hpm: phl rvs rfb kpq lvl
mgr: pfl dsq nnv hfw nlb chv mtv qrf grk
czg: ldd rnl
dwm: snz skq lsj ghm
xfn: dcg xnx tvx
dkx: gkw qth fmt qrh
nml: ttx wvz lfg
rcl: rzb wwh
shz: wvk vbt hlj dvz
ddc: pqf msn mdg hss bzl
nkz: brv bvd
tkc: bzx hfx
nzq: ktm tbt nzv fdc rzp
cpg: mnj vtb nbh rcx rjh sln
nvb: kgw kvc ldk dhg tpr qhj rpv zll rqb pkl
qcg: bwd qrv qxc mvz
znr: klq jmm mgz wtx fcw tvc xwg vzf ptk llg dgq dcq rrg
qfk: vsm lbp bzg tgv nrr zvp
lcb: vjs nvd
qrh: msn nzl kwc dkx
qsl: cbt cdp nbt
fql: zsp lrz rht
mvb: lsp mfj bxt nkh vwh
ktw: chj gwf gvs xpv
qpw: xtn nsg rqk rlv zws kql sps
zrk: msd pzk kdq
trz: bsk pmb ttl wvz xgp qmh
gpm: gjm lrb bdl vtq cxp
hhx: lxx nzf nbz
kgw: msd pfz nvb fsd
wjh: dgr pxc kqq tvl fcp
dfp: zvt zgv
xvc: ktm bqr mht tkc hvr vlr
pxc: xdg znc plh tck wjh rwb wtq
zkz: xwg cbw fts
mhh: kvj hfx qxw lvw gzg dpd hkm shg
ffb: gzg tpr tkh nzf pbf trb kpn kvt
qzh: jrp spp
jxw: prm kgp qjw bnm jrv
cxp: gpm jgr
wnw: mrm cnr tsh zvp
qsj: gkw crq dzq
hvr: kdq
dpz: pld vfz
pdj: xmx rgp ckf hhx lvl pvl mwz
fvf: vlg zvw
nrx: bkp gjn xqc tkr lbx fjx mcj vzd
bwc: gjv tsg trc mhs crv szh
gfc: dmq bqt qls xpf mzf nlw vqj
vmf: mlb jcn fgz vzd
bzl: ddc lll bvq
nfs: dgr fjx
lll: fbc ptj
hcv: rgp npj
krj: flt krb snv wtq bzp zsp vsx fjh
pnh: wmx hkp hvr gbt whw
jcd: dcq chb jwb qfq
mdw: gdt mkd
cfw: hqq bzg gtt cbm mvz ptg htv
jrc: hkq ltq wtx zrh dlr
llm: rqk rrp bfz
zrz: cpz skg cvl tbj
mmd: vjf
lwg: hkp kch kgp
bfz: gvr znp
fcl: xdh hzd lwr kgw
vcs: sjn nww swz dvq dzd pgj
wcm: jmx fkw xrk pgv lzx kqx
qhk: zhj lvr
sgw: pgn snd sbs slp vsn
nkm: snq pdp qnb fmc vps
gsc: wfz xzp frs
kpq: kvl hpm xcs gwb vhd xzf ptc
bfg: nwm wcr ztc hlw trl txj vlh plx ldt
ktm: pdx qvz
bqj: kqq fvm rrv
qcj: pvl svg pvb rqb
kdp: nmq zpd cdw
hdp: wdp fbs
fnp: mvl lxf hkp lpc gbp whd zgc vmf whw pkq
nsd: dcn
rwc: qhg ptj tzb vfg tlj wdg
ggd: frm qwb xxg jqt gvs hkq
cjd: qsv qwn xqc
qvd: tnn kds wzr wqd pqf
fgg: rbv xbh dwt wrr qpk nwl pwl
ncw: mfw ptm dhb fgj cjz rjl vwc
whd: qlx kqb
mnj: mvl xnm cpg fgt xmt cjd qls
qcc: kwp kmp tnx zsd
fjh: zdg
chf: dmd vsn cjb nlb xhk clb rkm klq mnd xsf szh rsg
hfx: mhh bnm tkc jdh txd qkz hhv
gbg: pwf bjr thj jxb qhg
jkz: gpk gmv bkn lkm
zpt: grp wlv tcc
hbd: bwb tgb zbm mkt wvk gsp lsr zfv xkq
nsl: xlg hfq wvk
zvw: csd zpw
vwx: kvc hjc tkh jtr nxl rjh jrp vtd kzq cwd
bls: hdv
qdp: gbk dgj rxq
rfz: frd gxf rzb xxg
vwj: llg pfx
ktx: mkd shk lvs mcq tln twx dxd mkv
wdl: kqp zgg fdt sds pss dcg chl dkb nqx nkm fgt lwf hpq
sps: ntb qpw vwj
pvl: ksz pkg prb pdj lpc qcj ldk dzw
gsp: vsc dns
xsp: sjm dmv
rqx: jcc zrd gbm fpl cmw vzf hhf
mqz: lqd cpg qkk vmm
ddx: kxw bhf hpv rqw vvt fgt wfc
lmk: pfj nvd
dsq: dcl fnk wwt cgj lqt mgr
wzj: jls fwt nbt xhm zkw nfn ssz brs
zrh: jrc ksw nsp
jcc: rqx hhf kjq pdh dpz
hvt: rjl lfs rnh lzx
vlh: bfg rnh zdh bqq vsp xwf
spf: mmd jrv lnz wwq ckj tlh fgz nrz xgl qsx kvj bhs
vjf: bkp fsd lnb
grf: smt bnm
wbd: lsz lnz bcr
jls: pnf dhq
jmw: dvr gwz qlv hdb zgc xlr
sjm: vdj dsj xsp lnj npp rwn
rrj: xkh rcx
jzc: zlw lrb lng sbb xlr jmw
brs: xrk
msg: zmw wnc fxl sls
ggb: mfj plj jcr twt lws
zbr: pwt vbv qdv sxg rtm pns
jsv: scc rqb lnv
tzk: gxb kxd hvf xvz gdw vjc rvh tdb
mqc: mtv ksh vqz snd zfv bht plc bbz
qkb: dtm fcb xsx lwf vvd hzf nbz dcg mnn
vfz: gmv zvt
hfm: gqr qts zpm xbp wnj sqn
shs: kmx hcb plw mcs nmb gvj knb
hhv: zcv xqh bnx hfx
dpd: zsn qxw qdv wjh
svd: cbt xhk
tqv: vsp pfm pdb kht
gxb: xvn vbj qxw
rrc: wwt hdv zxr fkw gvh rxq xxq
kkq: gxq
fvm: bqj prb
cbt: wgf flg rdp svd qsl bgx
lbl: wmn zxr rjj
mcq: ktx zvq jvg nkc
jqm: ctg nsw nzh sjd lrf cnh
plj: kmx hnp ggb nzv kzq vbv
dkf: cxl
qdj: mws vfg zpm kqx zkw lzb rjj vdk mzw
hsb: ksh jct dsg
gvb: mth vhd bvf tlh knb ggb
rlj: dvj
qvk: crx fql vcj zzl psp tfz
rqw: ddx hkm mvs jlf
qzb: nrw kds rrg tss mxx
fjr: lnc gvz mpk bld jwg ndr pdh
tsp: jrl bzp sls smt
fsj: cdq dcq fqd gfq rdm zws qsn jwb gvz
zlg: ptg tgx
nxf: fgt jqv mlh npj nxv
dts: fmh wdg rsg fkw
wcf: xmx tbt fdt gdl mvx
lxx: khj hhx jtr cxp vzt nst dvq
mth: nwf snm pfz chl qsq hcv psp tnh zgg vtq gvb swz pgj
kcv: lqv xcd qmk
cvl: lzh cxb jsw
pck: hdv mpt nqz
xtj: bml rqj ttr nss rvs
pqz: nmq qcj qxw nvt dwt mtg
sgd: rxw nqz tsh tll slp qsp qsw
sfd: fmk rkn
kpb: hcm
pzb: dfn lxs hbr bjw bgw
lmr: fmk jmm qxk szq dzq jrx
hds: mkb dwp rnl hsf
zlw: hcv vjc xzf
xdv: nrz
zvp: grc bzl wnw fzz fzc dhs ktw dtc
fcr: nbt rtb chm kzm
bhs: gwz lpc vdc gmt mfp hzd
nvt: fcp
tlj: xwr hkj gsb chv hzp rwc crq
nxv: lfm gpv
rlk: lzb plf xsc drs vtw tqv trp phf pvq
qvm: qkq nst xdg
vbb: lmt vlg fjk tbj jcp rnn
tzd: mgz vtw lgd jzb jcp mfh jmh
mqn: jdt gdf
zws: fsj fhn csx cbs qpw
psz: rxx snd bfp wdb lmk cbh
zjk: znp bls gvq pkd rrp llg cnr shr nbt
qgh: dln jtr dxd
hbj: rqk bgv fmt dqt
szr: vxt ttv cxj djt vrv
hdv: pck llp nmd wml lsq bls
bmm: rrx cxj fkz bcm fzk
zmm: kds sqn xsf lvb djs lqg mcp txf
qxk: lmr slp mmv
vtd: zjh qmh kvn zqb vwx hzh
bld: xlg fjr pdb
fzz: gbq xwg fqd zvp cfs jpf qsw rpf jhf qrv
xdg: vvt pxc srh jxd wfd tck qvm
bgw: hps pzb wsh glq
rkm: zgl chf
gbn: gwk ghb rnr xxg
sbs: fmt sgw lzb rmg dcn fft
kdx: mhs gmv tsg smq cpv
ssw: gtt bld bjj
rbv: fgg nlw bzx
vdz: dgr gcl
jkm: qnk ztk bvq
wrb: tlz dfb
wwh: tds phf rcl jhf glc fqn znp
rrv: rgb nrn bqj rht prz
mcc: bjw smq vbc
qlx: rqb kmj whd snm qkz tls
pts: ckp kfd vtr rrj jxd
snv: ksz twx
tqk: qsl
cjk: bng
kvt: swl mpv xvn ptc tnv fgz mcs
bqr: tvx xvc jzt kfd fwk pfk
pdl: mtj
kxb: wfc jbt nqx kmx nfp jfc mlh pdl
fmh: dts mpk rcz
rnh: pdh qvb
jcw: xtw nnr
rxq: tpg xhm qwk
hsl: hgn jlq tkr wkz pfc
qns: jnq ljq hvf
hqf: dhb qsz lnj
zzk: btf pfm plx
xxw: klv bls btd bwb pxg dsr nrj gqr tgc bvv gdm pxj gbg
xwf: chb hpd
pjm: bmb qcg jdr mmv mfw dcl
kmx: trh
fdc: kpv dwt fmc
wnj: hfp hfm
xkv: cjx kpn
rzb: jct rcl fzk xwr
bjr: sxk pdh
ncx: cmc
gjv: lqv dbg gwl
dcg: xfn lqn jgj rfb vqj hmv
fgz: kvt fvr bcp
zgl: rkm rnr bbs bfp qnk clb
xcd: kcv lwd jhs vqz lmq dmd nsl gws
xpq: fkz mpx
xnm: wkd
gqf: tbf cmw kgf hqq lvr
zll: wgz gvj gxb
zqz: vft vxt vfk
lpc: pvl xdh cmp nxl lvw vvq fnp
pzk: kbp fsl hpm zrk lsj fns fmc
nsg: qpw rjz
hjg: vqr gfr vxh
nwl: kqp lvl sjd gjm
pzt: gbt spq pdp nww
gwb: tdx dbm vcq
cmk: zmv gvr cvp mvz xwm mpt nxq lkl qgm xbf bpk
pxg: xxw dhq sxk dcq dfp
jfr: fgj slp dfp kcl llt fcr jsw
pzc: qkk nfs pwt bqt
tqr: pwl kcg
ztz: fzw rsn
grj: djm jww mkb dvj ltq
pfx: skg khp vwj fzj
bwb: wzr
lfc: fqn
ggm: zzd zwk tll gqr hmc
pzn: bnl tnn bwc xnp mxh vdp lpk
frs: pqb gsc rdm
sds: vnv wdl khk cdw
jxh: fbp vvq wgd
kht: jxb hfw hlj
tjm: khp hsb kzm
wfz: gsc sxk bbj
cpz: mwn lgz fbj qvz dsj nsk zrz
jpj: mgq pxv snm twt
wgf: zgv cbt
vrv: szr fzz mkb fhs wzt rkn xkq
bnm: nkh grf qcz xbq hfx vqx vdz
tpg: qkp fzc mfh znp zxr rxq
mwm: bgx vjb cbs bwb ckz vbc mfr
flb: hfw hzm
zvs: vdj tzb rkp csj
gbm: qhg jcp tnn
jbt: cst wwj dqd
gvh: ksw rcz rrc
gsb: dlm xpq jzb
nmq: pqz wlj brv hcb bvd kdp hzh
gqt: pdx qvv ghm tjx kvl bqt
vzb: lbp lqt mlz dwg zsv lnj lgg fpl qrg
sbb: xqx rcp jzc zjh lqd sxc
kdj: nkz kqb nmb kmf grf vjn zhn
dwg: tgb jct rkp
gjn: nrx wnc mwz dmq
xkh: lvt rrj wcq srt ljx vdz
bzx: tsl htg
plq: ngg hhv pnh sxg gjn
rjl: mpt lqt dft hvt fpl cxk grc
rxd: bgc bmk xvn pkl xnx nbz kzq
zbm: zbt djt hbd
tfz: plh qvk ckf
gbq: ddf hzp
lqv: rsr rjr gjv wmn
fdf: mxz qvr bnx jpj scc bjm wcf
fkh: mpk hqf
cqv: hsb kjq wcr pld rwn
cjb: xnp xrk jqr hcm fbj mhs tzq
lpj: wdn
cbw: xxq gvz pdh zkz mfn
dmq: pbf rqj mgl
zgf: kgp vnv xff fbs
gkp: qlm zsp srn pfz tkc tnx
nzh: brv mvx pds jqm
nbt: qsl lsr wzj ptm dmd fcr
wwq: njt spf snm rlw
nwk: qnb zqr cjx xlr
bjs: bgc
vcq: xqn hms pns djg gwb hpv
jcs: rcz vtx ksh thj vjb bkn jqt lhb
fwt: hqf chm
vtw: tzd czg flg vfg jck lgg mmv
mht: jwh
fvg: qkq jcn hpj rtm bpx wzd kmj pzc kvl
krk: ksz qls svr
tsl: dfb bzx
qnk: jmx fhn
rrx: ntb jcb ddc jbv rtb bmm rdr
ltq: jrc qzc grj
dbc: lxf htb nss jcn qvm
mpk: thj rql clx qsz hml vsc fjr fmh qzb fkh
vbw: znh mnn qlv thc dbc
cdt: psp nqr hhs
zhj: jkm zws qhk dmv kht hzx rrg ptj dnl dqt
fbj: htv mfh xnl cjb jwb cpz xbp csn
xtw: svd khp jcw xbp lgd
rvc: cbh rcl dsj
dwv: pfl
kjq: vdd kqx cqv zqh vkp jcc lbl
mkg: lzp bzl fhk tgb dqs bgs fjn
jlf: xss
ckp: hpj lng xqx
xjl: fls wsf mqn rbc gvh mzw
mlh: kxb wkd rlm
hlj: kht kzg hst rpf
lgd: tzd cfs rrp
wdp: ngg dfd djg
mmv: vtw
lnv: lvw lxp jsv xff
qsq: xcs tts mth bvd nmg ktx
dkb: wdl
vzt: wkf dfd
fns: gbt mkv
lrd: mfj vvj fgg gbz rvs gxq bvf ksz qdg qwt rhs
mnd: hfp ldd glc
bwm: qqv bgc qpc
mft: kht mfn hfw jqt lxs dgb kwr
hnr: cnc dmd
mlt: cmg ktf pwl fxl bcp
qgl: tgb rjz
xrk: brs cjb wcm kgf fzg dfn
nlb: zmv qzg chf mgr scd rmn
lvs: nkv ttr cxq ktx sjn fdf mzd
tgx: pfl tqh hxr zlg crv
glc: qzc wwh mnd
vvg: tcc plc nqk
bpk: nqz cmk szr tmx jvk swc dwv
tbj: zrz mfw gmv vfs zvt
nfl: jzn ktm rsn nrz zbr fzw
wgz: bnv rgs lpj
vqj: dcg tgf gdw
znh: nmg bmn mcs dzd vjf
bvq: fjk gwv gtt bzl jkm
rpv: nkv qvv tdx
lsz: lrz tbr xzf rqb kpv gzq xsx wbd
rkj: jdt tqh ttv csd flb btf
dhg: nvb qkz bcr pns qkk xpf sbt
crs: mnn ckb qcz cwd mxz
rzj: ljx gbz
vqw: hbd fhq zmb lsr cdp wnh jmh qrf fkz
fdk: ckg vsm gfr
cpt: zpm wml lbp plc dnl nrj fls llm
zvt: dfp vfz dft dhs
wrr: fgg sbt tmz fvm jlf
nmd: hdv gdf kql cnc wsc lsr
wtq: pxc ztz rzp vbj zdk pmf zdc
jmx: nsk gqr wcm qnk pwm
jtr: fwh qgh mlh ccs sdz mks lxx
qvb: sxj rnh fzd wfz mtc bwd
qlm: nww qcz wcf jxd gkp wnc ckp
xjs: xtn dhb sqn qqp mdg cfs
cxk: bbk sgv fdk jcp nvl qwk
pns: vcq gpb dhg lng
fwk: trb
wzr: hsf bwb vfs ttv qvd bfz
hvf: tzk brp
nrn: fvp vvd pgj
zsv: dnx cnk vzb dwp llm rsr
kld: hlf gqb fzl
lbx: nrx gdn
ltl: pqt ltq
vnk: lfc jsw zxr cxk hhf
dwp: pwc mrm llm zsv pqb vhc xwm hds
pwd: lwr ccs mgq bdl rwb
lnc: gfq fjr
txq: pwc scd vws qrv rtb mlz zpm
hzx: csd qth ddf mfd
fvp: hzb kmp nrn zqb nwr shk rph kcd
mpv: cxl
djs: zmm hps zrz lwn
rlv: lwn csj hvt gdm
khk: rzp
hcb: dkb fdt zsn
bht: mpt vsm
cxj: bmm gwf msn szr gvs
tlh: fbs jgr
mhs: kwr gbk kdx
mdg: qrg xjs
nbh: rqj hmv hwp cpg vjc
bxt: gbt
sjf: ncx tzk wzm zcv
dvz: fjt jmm shz
ntl: qwk tgc mdg pqb dxj ssz hds
pxv: gdl twx qzw npj
gqz: tlz wmv dgr
jzr: ttb slp rhq wsf xsg kzm
hsf: bjr hjg
sgv: zdf rvm mmv
shk: txd vmm
tlz: fwh bjm vgf shg gdn wrb gqz xnx
tnn: rkj gbm kcv qvd
lfm: kpn pvb fsl nxv
chj: wdb fjt tqk gsc txj pzm ktw wlt jmx qgf
wzm: krn wwd fzm dtm
htg: bzx kng dkf
rrg: qts znr
zzl: fbp jcr hzf rpv
dvr: wnc nfp
ksw: ntb cbw gvh tgc kxf ttb zrh
kcg: jcf cck znc ghm pmf tqr
rph: fvp ldk qgh nwl rlw tpj
wrc: wrz dgq hnr
jlr: zdh pbm rnn mfr pdk hhz htv ltq nsx
xbh: xmx jcr dtm
jlq: cjx bdl vtq hsl khj
mtg: pqz nnl lqm pxv
rfb: bvd
kgq: vrk fhq fkw
mjp: chb vsm lfs zxr qhc
pdp: fbs jcr
qvr: gpg
nzl: klv gbk chv fpv gjs xsg
bvl: srh vvp mht rqb ktm cnh ccs qkq
lqd: qqv nsw ghm
vjb: vzk mwm jcb dff jcs
kbp: ksz wgd bqt
tzq: qsd pvq nsl nnr lzb
chq: dlm jkm mfq llt cdq
lqm: lrb lbh mtg hwp
tfr: jqr kxf wbc fvf jls tbs
xzf: krb kxd qvv
znc: dvc kcg tjx
lvr: rqk rmn
vqr: xwm nqk npk hjg dtc nsp
mxz: crs ktf cww
wzt: vrv ltl dlf nqz nhc vdj
xwr: fdk fvf pgh kgf
txj: dlm nlb bfg jvp pvf chj
zbt: wlt vfg
crx: dwt qjw kdq
wwj: sxc xsz tdb shg tnh vjc ckj mjk tdx jbt brp
kcl: gsc szq vzf plf mgr jfr
msn: ddc trp jvp fcr
rvr: qvr tln kmp gxb gxq
ttr: lvs ccs
jqv: mvs hpz jdh
llg: vwj flb xdc rpf
spm: xvn bml qsv
rqk: qrf lvr plc zkz hbj qdp llm
pmb: skq wwq
lfs: pgn phj
zqc: rjh pkg cmp
rgs: vcj dxd zjm tnv wgz
jmh: ncp tbs ztk vlg zfz vqw tzd
hhf: vnk jvp
shg: mhh bwm nmg tlz qls
klr: bgv mvq nfn ghb gkw
xsc: cdp mpt rql phf
zgv: hzm gfb dlr dfp dhp smq tkw wgf
txf: hqq llp qdj
zdf: pnf pvw kgq fdl fkw sgv
ghb: tsg gbn
wwt: rrc dsq
hfp: lwn pvf mnd wnj mlz
fvr: tdb vcj fgz xqc
mkv: ktx
tzb: fbc lsq wbc nfn fbj
hnt: hhs pgj khj tvl srf lsj bml
gxs: bmn xmz qww qwf
zqh: gxf lmq sqn
tck: krn xdg
dzq: jvk qsj pfl mrm fbc
pmf: kcg ckf
pdx: gqt ktm pss nkv
cxq: lvs krb kvc lwg
kxf: tfr
bbj: vxt wfz
dft: zvt hbk rjl
prz: scc qsv bzr
nww: wfc vwx xmx nhp qlm hzh kxw gdl vcs wmz pzt
bth: fdk pgv
smq: vtx mcc lwn
bcs: xvq nlh qdv
nhc: hfq xxq xzp
vxh: wdg hfq tgv hbj jbv hjg
nlw: dwt tjd rbv qvv cjd
fgt: mnj swl nxf nwk
njt: rlw fdt wwq fvm
xlr: tbt jmw
xlk: vjf xnx fcb bsk tfz htg
mfq: dgj
rwn: crv xxq rjz kld cqv bht
vtq: jlq dvr xqc xsz gzq
lxs: mft vfk
fzg: dff
tjc: fdl vlh vws qgl zbt gpw hss dcn hmc qsl
jbh: qff nxl khj hhs pbf
kvc: xgl nvb
tcm: dkf kkq ttl
qsz: mpk
jrv: bxm qvr
dlf: wzt ttv hml lfc
vxt: zqz dbg bbj
mlb: xww hdp
bps: mfp mtf xkv znc vzt
rtm: zbr
jct: dwg
ldk: nvb rgp mcj zgg zdk
hfw: bnl flb fjk fhn kht
ddf: cdp qxc hzx gbq hdv lsq
dmv: rxw xsp bjw
dtr: gdw hzb
dcl: dsq tzd xpq lgd mwn lbp
vfk: lxs cfs nsp zqz jls jwg
dgr: qjw nfs jrp gqz zdk vdz
fbv: npx jsk bqr gzq mlb wmz srf
sls: tsp
npx: tdb pfc scc lng dln vvp fcp
xmt: jkb jcf vzd mnj
ckb: wlz jbh
xbp: skg rvm
mtf: bps brp ctw prb whw grf dtm xss
rdr: rrx wrc tkw zpt dsb cpv
csj: rlv dhs
qwf: lsj pbf xdv mtj kvl gxs
qsd: bwl tbp qhc tzq hqq
qls: gfc krk qlc shg
sxg: fcb hpz lqm pfc xnm
vsc: gsp lzp kpb grp jpf
mxh: mpx
fpl: vzb rqx lcb
mfj: ggb mvb nst gdl
frm: lnc gbn vxt vbt dmv
pbm: vzk jlr
xbf: dff cmk rnn klv
jqt: jcs mft wpx psz vdk jhf dsr bls
mxx: gsp drs nfn nvl mjp rtb qzb bwd
cck: kcg mzd
cdc: vsx nzv qls htb dfd sjf qdv wkd
dqt: hsb nsm kcv vdk djt hbj
hch: msd rvs fmz vvt hjs
jdr: cbm vlg pjm rcz
tbr: lkf qqv bjs lnb pwl qwt hvr lsz
nqz: zmh hmc pck dcn bpk
kql: tgl fhn pbm hlt kzg
hpz: jqv hdw kdq
wwd: rzj jdh tqr
mgq: jpj
bbs: zgl
cmw: gqf qqp rqx btd dhs
pqf: ddc qzg lwd
vdk: lwn bjw
ksz: dzw rbv lrd mwb krk kbp pvl qff mcn wvs snv
kwr: mft mhs xdm bnf gwv dgb gxf jqr
fkz: qxk xpq vqw lzx qbd
bfp: vjs phj
vfs: mrk lqt xwf tbj wdb lrp qfq qzp
tnx: mnj nrz gfc srt nxl vbj gkp qcc
fjk: djm hfw kgf bvq lmr
kqb: kdj cxl
mrk: pld vfs
dvl: gdt kpv qwf nlh
ptg: zbm mhs jcd csx zlg cfw kpb fhn dcl
chb: xwf cbs rrp hhz mjp
bhf: nmb
fdl: wpx ptm grk zdf
bjm: nkh xvq qcc cjk
kxw: nww kkq lfg bnv qgh wvz
trc: zfz ndr nrj qzg
pgj: hdw lwr hjs nrn
zjq: dbd jsv pmb znh hvb
ptc: xqn cck bhf bzr kvt swl rht cxl qgj kpq
xcs: hjs zqc kpq tjd
jrp: qzh djf mnn
hdb: jmw xqc rtm dzd qwt
gmv: pvq kdx vfz
xmx: bvd qkq vjn khj wcf xbh
smb: vft lgz pfm qqp
mkq: txd mcs ghm wkf pfc
rmp: brv krb xff wvs ttx pfz snm
qts: gvr vft pgh rrg plx
dxd: ktx dbm qgh
pds: nzh qgj nml ljx rgb hwm kxb
rxx: wqd psz
ttb: vwc gwl
zmb: szr mpx xsg dsm bfz
jhf: jqt fzz wwh
lsr: vqw wvb nmd pxj
hpq: fns kmf bpx brv mmd ncx
vvp: gcl mpv jkb
vrk: kgq swc hlt cwq
bqt: kmx gfc
tss: xsf qwk lmk nsp rnn
lmt: vbb zjb pqt
nsm: rkp lgq sxj chv
twt: tbt gjm rwb
jzt: lrf jlf bqr
rmg: sbs fzj kgf hss zmv wfz
cpv: rdr djt
xqh: mgs snz hhv wlj
gmt: fwh qkk xsx plh lqd
qsw: drs crq jcb fzz wwt
zdk: kdp qxw lhc dgr cmp
swz: tpr nmg xqn kxd tmz wfd fvm
lrf: dbd jqm kmf
trb: lqc fwk lwr fzw
jgj: pss brv hsj rzj
lpk: xlg rps
rmq: nbr jxd hdp gpg hcv ktf qvj zbr hmv vnv ngg
gfm: grk
ztk: jkm lzx jmh
srf: pkl mtg flp fbv xvn
kcd: smt xbq hvf qlv fvp
rnn: vbb zwk
fcb: xlk zcv mkv pmf xmz wfd sxg fbs
dhp: lvb lmq ssz
xxg: rfz
dhq: gbm pxg qvg bjj lhb jls szh
gjc: kpn rcx
zdh: mws zqh vlh jlr qgf
nss: wmx ctg dbc
bgx: mwm xdc jck xjl vdk cbt
jnq: pxv ngt mcn qns wcq hzj xdv
pzm: vkd kds xnb gtt mmv dnx
nzf: lpj hdb gkp qdg mwz hhx krp
hpd: jdr xwf dxj lkm gtm
qvv: gqt srh
gdf: mfh klv gfm pqj plx mqn
kqq: wjh sln vwh
rzp: ttx svr khk nzq tnb wlz kxw wtq trz bxt
ngt: rcp jnq
qsx: kwp lnz nlh jrl snq wcn kbw tvx gjc spf
crv: dvj qsn nsm mrm tgx
tjx: gqt jhz
qzs: wmv prm lrb
mbm: vdp rpk khp
tdp: kwp xdv hdw fgz pxf vcj jlq
dnx: nvd qqb
kmf: kdj xvq jsk zjm
xlv: bgv ssw xpv rlk plx tgx mtc
qpc: bmn ljx qww cww
tmz: xvz wrr smt
jbv: vxh rrx
cts: lwg lhq cjk gbz xww
khs: ckg pxj
zqb: lws vtd
cmp: lpc zqc kqp zdk
hms: cmc tqr fxl tgf
txd: kvn shk gvj swl fbp hgn zdg dbm mkq krn
dqp: wmz cmg
gvz: bgv fsj gvs cbw
qqp: plf kqx
jmf: qgk
dsm: ddw dtc
tgv: bgs qfk fmt ddw rdp
rbc: mtc xjl
gfb: zgv vqz clx mdg
tgb: mkg dwg hbd qgl bkn bjj
gws: ndr kpp smb cwq mcc xcd txf lsq kld sgd zqz
pwm: jdr gtm dns jmx fnb
rkp: rnl gbn dwg dns khs zvs nsm
lgq: txj nsm tgc fkz kht gmv
vsg: fhk gvq pdk
jwb: gbq lbl dzq rjj
ndr: cnr pdb
mpx: brs flg mxh gfb zmb xpq ttv bnl
gdn: sdz qgk lvt lbx tlz rht
nxq: mkt
gpb: djb pns frb jzt wcq qnb
vwh: vbv qdv pvb
mcj: nrx fwh xgp ldk qsv
flg: mpx qzt gbk rnr
hkj: jzx gfq dlf hcm hml pfj vdd pxj tlj
hzd: cww htb mtj hmv fcl
gzg: gjm hhs cst vzd tvl dzw
scd: hrs nlb jwg chm
nkv: lvs tts mvx rpv vjn gpv pdx
csx: zxr zws
fcp: npx wjh dxd gdw vtr rvr nvt
zvq: vqx mcq dvr
zpr: twx gvj lws kxd zqj
grg: gsf sbt pmf grf jgr hvr nxf lrj lqc
tvx: xdh vvd xfn kwz
skq: dwm zqc bdl qzw gfh mqz pmb
sqn: vft sdk
llt: rjz dgb lxs zbm
gvs: ktw fhk vbt gvz
kfd: fjx brp bqr
vtx: rxw mnd smq mws qzg jvk
krn: txd tck szx bmk hzh wzm lkf
wrz: gwk hvt wrc bbs kxf fjn
cnh: nhp zpd
tln: vjn fdt
flf: fjn xsp xtx dtc wcr
tgf: hms wjs pjp
hzh: krn nmq vtd
pxj: khs xsf xxw hkj
xmz: fcb qzs gxs jzn
tkh: xgp vwx wkz tjx pjp ghm
dqs: bcm zlg mkg vlg
nmg: shg vhd hpz nss
kpv: dvl fdc sln chl lsz
dln: nwf
wnc: qlm gjn msg dvr
sxk: qkp bjr
vvd: tvx nrn flp tkr
qrf: mgr
cdq: fsj jkm chq gkw
wqd: gjs hcm qvd
rkn: sfd pck bnl nwm gbk
pkg: gsf khk nkc pvl zqc
pld: mrk hbk dpz rnh rtp djt cqv qsl rvm
vnv: sds kgp zgf
tvc: znr qwb lmt gbm hkq
gbz: tnv
qnb: gpb gfh nbr nwk dqd
fhn: qnk zws
pfk: mnn jdh ttw hxx
bkp: lxp tcm sln tjd vvt vjf qcz rbv
lmq: xcd jqr
qkk: mpc gmt pzc qzh dhg
cnk: wdg tcl
fgj: ncw zzd pdk jfr
srn: bqj wmv rgs gkp nwk hdb
zcv: hhv
lsj: hnt mcn pts dwm
tkr: zlw vvd npb vmm
rgp: hgn mlh wlj hcv pjp ldk
rql: bnl pqj qgf
wcr: mkb cqv
bdl: pwd kdq ngt
wvs: ksz rgb vfj sjn
rbr: zgc sjn
qhj: htz mgs xqv qpc wwq
wnh: bkn mcp
whw: xfn srf cxq pnh wds gpg mtf cdw xsz
wdg: vmb rwc xtn cnk rpk
qmk: zrh zmh nsd jzx kcv qvz ssz
wpx: vnt cjz bht wnh xdm rhq nqk
cmc: mcs hms ncx
bzr: htb
rcz: fwt nqk vfz fcw gvh vws fmh jdr nnv
klv: xbf flb nsp xnl
jcn: wkz cmc hms lrb rhs
mvx: wcf rlm nbr
wvz: tqr
bgc: bwm shk zrk kcg bqj jmf rxd njt ljq bjs
kzm: glq tjm
fsd: gcl tjd kgw
fzk: bmm klq
wml: hdv mwn mjp wlt cpt
phj: csd qgl
wlt: phj
mlz: txq
vqz: mqc lnc
khp: pfx xtw wsh vwj tcl mcp mbm bbs hbj qhk tjm
ccs: jtr pwd
zhn: srt rqj shk tdx mjk
cst: qsv
hlt: kql rdm wsh gjv zhp mvz vbb tcl vrk
pbf: ffb nmb qwf zrk jbh dmq
nsk: hzm jmx csn
sjn: qsv lvs rbr
wlz: ckb rzg dln mcq zhn cdw rzp
hxx: pfk rjh wdp nkc ctw vtb mnn hhx mcj
wjs: fdt qvj tgf
tls: qlx qzw vsl qdv srn lxp dtr
vft: vdd smb wgf qts zqz sqn rtb
hmv: nbh lxp rmq xff hzd zjm
hnp: mjk lqc wfc
djg: xqx
vmm: wkd shk mqz ngt
gcl: fsd xvq vdz vvp
lgz: fft tds jmm vsc zvp smb
bxm: jrv dqp zvq jbt
wzd: sjd mdd zdc tts rtm lqd bpx
jvg: svg bzp hrp ckb mcq qsq kwz
vtb: hxx spq bzx cpg
wsc: qvg bbz nmd pzb bbp ddc gsb bnf
dsr: fls jqt rdp lfs
gdl: mfj lfg wcf pxv
pnf: zdf ztc csg znp jls
bkn: wnh jkz
cdw: whw vgf wlz
ddw: dcn dsm mts rmn
hkq: tvc smq cvp grp
zxr: mjp vnk csx
ttw: pfk
swc: rhq zkz
ndt: bwc bbz qsp fzc hst ztc jzz
skg: xbp zrz tgl mrk bth pfx vnt kbm mbm
wmv: nkc gqz bnx zdc
sdt: bjs lwc hkp xkh fvr wdn
lzj: hzf nss zsn smk jkb nkj
wlj: nmq kgp
wsh: bgw nhc
srh: svg xdg
scc: bzp jsv xqn prz
bgs: lcb bth chm tgv lll
pfc: hsl npx jxh ldk kfd tkr ljq sxg rlm
tbc: fcw hqf mft qcg chv bbj dlm dxj xdm
nkc: smk zcv qmh wmv pkg ctw mcq xcs
lwd: xcd
wvk: pdb bnl pdh hbd nsl
qkz: dhg vbv
dzw: dtm gzg
gwv: tcc mnd xnl bvq kwr
ckz: vsp thj
vbt: lqt
nmb: frb rhs
rzg: wlz nrz dvq snz lws
dqd: gpv
gvq: vsg cbm rkn pxj zjk lrp
tqh: trl gdm bbp pnf
bsk: fns krk xlk trz rjh pxf fdf wds
jcx: vhc
zpn: kgq rbc nsx pkd qwb rmg
vsn: sgw tbp chf fmk
rht: ptc gdn pmb tth
qwt: lrd hdb xqv bnv tbr
lnb: tbr frb
lng: jzc ckp pns
kmp: rvr fvp
qwk: ntl vbc tss
qwn: bcp ttl cdt vjc
jsw: zfz qvg vkp vnk cvl
lzb: qdj qkp rlk bbj
lhb: dhq ztk jct
dsg: wpx mtv hsb gsp lvb wdg kgf
xnb: hlf xdc
mll: bwl trc lcb hfw sgw mpx
pwc: jzz dwp fqn chv xzp ntb
gfq: lnc gsc tss
fbp: zzl fbs tdx qdg jxh
qkp: sxk gbm qzp jcd tpg xbf qrg zgl nnk skg lzb lsq
fzl: nnr
rdm: rnr fsj mzw frs
phf: szq xsc hsf kzg rlk lmt wwh
xqc: hdb
cnr: nrw wnw ndr rpf zjk tgb grk
hqq: gqf wcv bfg glc mts qfk vhc qsd txf
gzq: fbv vtq pkl
xbq: bnm vtb hpv kcd rlm rrj gbt
rqj: xtj nbh dmq tth
dpc: gdf hzp cpt plf gbq csg kld llp xxg qqb
xww: smt mlb rtm cts
hzb: wkd dtr bnx xsx fvp dxd wds
qsp: ndt ztk rtb
mtc: xlv rbc ckz cbh qvb rxx dsj
cbh: kql
npk: vqr xzp rpk pbm wnj lnj qwb vnt
mvl: qgj cmc nwr kqp
nkh: mvb mjk bwm cst gbz
hlw: cvp pdk
tbt: swz nzq zgf jgj twt pss cwd xlr wcf
rcp: sbb srh ngt spq
ttv: wzr dlf nvg
khj: gwz jbh
nrr: qfk jcx qbd trc
xwm: cmk vqr rkm tcl jsw llp dwp zkw hvt
lwf: wdl fwk nxf prm
ctw: hxx kmp pzc
wlv: zpt mxh gxf xbz fhq mtc
kgp: wlj jxw lwg vnv zgf
fkq: pkd bqq szh nxq fqn
jvk: dgj ldt hsb bjr dzq pqj
slp: dsj hqf jzr
grc: vhc tbp zvp jzz gvr rjl
vhc: jcx tsh pfl gsp tgc grc
pfm: zzk xnl pgn pvq smb
wmn: gjs lbl
dgq: mpt gbn znr
trh: kdj zqj kmx rht qgk sxc gpm wwd
qww: kdq jmf tjd mwb wgd lnb twq qpc
npj: nxf rwb pxv
tkw: rdr cnk thj
mvz: qcg cmk jcx
cbs: hhz thj mwm
gqr: vzf bgw hfm
cfs: hhz lgd
lsp: jcr kvl qns zcn hvr jvg vdc mvb pwd
bml: qpk ztz tvl
rwb: pxc sds twt qgk npj pwd hwp
rhs: lrd nmb djg rlw pxf
fqn: pwc
tbs: tfr jhs
jgr: grg mmd cxp tlh vwh kgp
hrp: wmx jvg
nqr: cdt kwp kpn crs gzg
lqc: grg hnp bcp trb
mpc: plw dpd mwb rgs qkk wmz
xvz: rcp sbt chl nkc tmz bng
phl: rbr gqz kpn tcm nfp
kch: rpv sls lwg jxw nbr vqj bmn
mgs: xqh kpn kvl hsj jfc kkq qhj snm
smk: knn fmz lzj hjs
vdp: hhz qxk rmt mbm pgv rhq rxx nbt
hwm: lbh hpj qlx hpq bxm
vsp: vzf ckz
gxf: kwr
jpf: qrv ssz
qsn: fzc wtx csn
cgj: xbp xxq zfv dsq
bnx: fdf vlr wmv hhv
zjm: hmv fzm
zdc: qjw wmv vlr lnb
xhk: vmb svd xbz lwd gbm
mws: vtx
zmw: qnb dvq msg jfc jwh nlh wvs
nqk: vvg tcc rcz
zsp: fql snv dkb twx
qlv: hzj kcd
bqq: xdc mqn fvf clx
ztc: mcp
nmm: rbr mlb jcf hpv xww pdj
gpw: frd gpk slp wnw hpd frs mkt tjc
qjw: crx dgr zdc nzh kng wds thc xnx jxw
mcs: shs
kds: zmm qzb hrs
cwd: tjd crs bdl bnv vwx tbt mzf
hgn: hsl rgp mjk gwb bnv
tsg: lkl ghb bwc fzl
rsg: dts zwk chf mcc rxw
nlh: nnl gzr dvl xpf bcs qsx zmw hvf
tgc: mrm xxw
rlw: njt rph tzk rtm wwq lvw hpm cck xqn rhs
kbm: jzx wfz czg zjb dcn skg
rhq: jzr ktc xjs wpx xnl swc
qfq: jcd rps zmv dwv
vzd: vmf gzg nrx jsk
fls: xjl hzp dsr vkd csn txj bwl
snq: qsx rcx xmt kvt tlh
tdx: kmx ngg gwb zhn fbp kmf rpv whd
lzx: hvt pvf wcm ztk fkz xtx tqv zpm kgq
ncp: zjb pqf bfp
qlc: msd jkb brp
dzd: znh lqn hdb
sdz: prz jtr bng
vnt: wpx glq
bnl: rkn mpx
nnl: nlh wfd pkl pqz qvk mtg
gbp: lqc zdk smt
mkb: wcr bpk nwm hds nnv hlw csj
kmj: vfj
nwf: tjx wkf qcc lhc rrv dln qqv
nfn: mxx klr
bcr: hsj wbd
fjx: jzn jxd kfd nfs
hvb: ctg nst zjq
gfh: skq wgd chl
rsr: zsv nrw
kzg: xlg zhj phf xbf mcc kql bcm hlj svd
djt: zbm dqt szr
pqg: jzx fkh rxq jcp nsd
mzf: gfc jzn
cww: mxz mdd qpc
ptj: dsq rwc
zqr: nwk
fmk: lmr sdk fnb sfd cpv vsn
fdt: wjs wdl
vjc: qdg wwj
nxl: ctg tnx lpc vwx
jvp: hhf dff
hpv: vcq
xsg: jzr
qvg: qvz rbc dhq qsd jsw hfq dnl
tnv: ctg
ktc: zvt rhq qhc qbd
vkd: fls wtx zhp
vzf: grp mpt nrw gqr htv vsp rqx zgl
kpp: gws bgv rkm lvb dff
