xbd: vwx taq mzb
abz: kvz pau yyt taq kzi rsp
ctv: hjv lal
uls: mvp esd gpd qel epd
vuu: bbf lep ncy pmz bps qts vrt qzr
nvz: xkf vvb dub ypp xsd doe
xss: hmh lfj nyo guv nrs sep
mce: tmr laf ifq gcx zsm miu qyu boy yig xom
yog: elx wwz ied cst hee caz
the: tmh sqb
ifq: mce xsd cio yqd dlg qns pib
lly: kkt qzq oqe
hps: imj qix zhr ffc lqy ged
xgd: udu gpd
uhd: web zcb csk vzj won
kvz: ilx wig rpn
kpi: tiy sqb phe jgt hqa dax bqr
iym: rle fna prh hcw dpv
owf: rwj
mvp: uls deb lvt dax dgp ebz sck
gpn: drc idw mfz ymx
rtm: wkk ysu grv vaj
nnk: nit lac krv mva tmq
zij: jrp mws ivs
zvc: mqv ljl qwo hst
tgs: fvr dcp vrt ywi
why: oqe fxz alo
cbu: ptk
etm: tzj ysk fls ydj elx jmx lnz
kqd: aid ryq ozm
dcp: ymx tgs cbr syv
qly: pvd ixf zcd ykr rcr
tpk: kkf tva
bbm: rfj ysg hqa
zal: pch fce
hxx: qhu wfn
jbj: tsg zqo oqw qab eml
gcw: kkt vaj qrj uiq kvz vnz uew kiq usb
erb: rgi qvq lvt wgi
wwx: sce tfi fpx
vyb: yox kwe shl
dtn: wds pcf
vmr: nww igd fwl lro
cwf: tpg ehs
sru: pmn viu scj krv ktq zba kvi fim ijh
sll: syv bfw ipx
mla: yzb ipg fdx oqw
huc: paz fod ntx
knw: voz vrf xaw avm rgg
dnx: hjw yig naa yao rhu cfw
bcc: yfb tqc erb bdi gzl
tkq: rtf fdx qlt ruz kpb ayp
uwi: ujp unm
wra: ebl
cnq: nbw hma acn bfd
xbs: wds
twm: enk stm yoz deb euf
wlc: xth dfy tpn bmk bdf
gjw: mco gns zfk tfi hee jmx lak
zvt: prm txg
atg: nyl iig zqs wxe tdk
jor: isc
iyf: kjg eic gts dhp afl dka fpg
dhp: isc iyf qyu mib
tje: jmw kes
enk: bnl ujz dor bmo smd sso yla twm rsr
kbr: blz sqg scj fna qlf yyn ohb
ucz: rzu umy waq xmd rwb
klb: sfd tpn zrc isc yrj oci och qtq tkf guy fst vds
urm: jac htr gzp
zby: qfl iem
fua: qge qwo whn set nsk zti tpn
frj: mbz lqy gns wpl vyi bhv grn wxu
qyu: zfk
lcs: zsr
otm: ugi ffc
jrj: jrp wxe qix
fmp: nqc xor ftb
scj: sru ipx ncy taz qqj
ryq: vqd qtt atg xvx grh kqd
bkp: mbt nus rrq naa uxz
dxy: ooj mms jpc nbw nbk cjj dxh ppc
bwl: gjy lww lbo zvo
kdq: gzl bmb hjw
ovk: fki ymx xnt uac nwn
hha: zyv bec ldw gmy ipo
kkf: fyv dhp jrj
dui: ulc ftb mjb gay
ilx: kxo kvz
dkz: lep mwe
oxr: eyj ehs fiq
mwu: vaj hgh ugt
zgi: wjd sqg
gpm: yfc ioi nww jzj zcb
ohb: ogf ncy rou vyb gjy
usr: csu uew edz wik
wje: wva gpv taq opp gjy web gpn ftu rwj wfe bps oab
osb: tty fkx bdf
ehu: kod fiq fst kew ktv zsm
xnt: ovk vis
sui: toy ezh wyy sys gbo
zbp: slu tpt vsu
hmk: wko wpl qrp hrk axf
bcb: lzo ehg why aev sbv aps rad
jmh: mhv
ngv: lep xnt bow drc dpv lfo ijy vua yji qjk
xaw: eqe
gjm: tom xsd uyk tvu gue yig
ehp: wvn rwb
eda: ykg tnm
vls: mva ghw ipx umy usr jiw ftc hzd phc
kkg: taa hwr yrj jmx
mqv: tdk gwz zvc wwi muc ngu
taw: kod wjd srg ivo sgc hci tvf nox
vor: wzn edz ohb ysu yqm
ksq: fsy chk yve tkf eyy
sju: zqc itc fql ivn sys wmi utp btj ppc vgf
rgi: iza pqs erb nij fvx
tst: dij jie sue grv ycy gla
ycy: tst gbb
zcb: rgg
uho: kiq oho bdy
hti: jcr guv wnc qnv
xju: fxb ybb udo
npm: dur oou tgs wfn ysu btq gbb emb lru phc obz
zad: meu ohv tqo qwh kam mbt spf
tfs: hnw jor bmb xkm des
ufk: prh ftc vyf wra
jdq: rrq
uia: kny dka gpd the
ffn: txp fzb slh zvs
zsr: ujz usn lcs pwu gky
vlk: stm owm dnf iaq ais
juo: mtk edp won kvi mcs
xxu: why cqv bps ppr qbx
cne: bdd vyf
nks: uxu rvk ksg qtt
adk: mzy awu
erl: rrq mbz jyw
dpl: bpe oxr iqk zsl iig iyy
dax: kpi niv afy ged
qax: yrj ntn ccs rxz
qjk: ngv pvc zcb qrc
bdd: yvj guv ioi dij cne llg jra
ayo: fra wai sat
gal: hxb mzl mrj
uiq: uep gqm wox mii wvn kck vyb
akp: axf awu epd qeg fls
cib: dmp zmj tfi
ntn: cst
wik: qyn sfl cyu yza muv ntx lep usr
ddv: ysa wxe voa wwz ypp
obz: npm wfn wuw vzj amv vef
qcy: vgf ppc lww yox ymg xoo ldw btq yuq
jzf: waq ghw
aev: bcb goa nyo jgz
rsp: txp eqp vzo ylh abz hzd wrg krv vrf vwx jra nbk jqi
mva: nnk btq luj
axw: gqv mlm wnv lkm ptb jdq xbs wxi njq
mvg: csy fzb jov jac vzj
qka: fcu lzo rwg
bcl: rpn fbi uew
ujz: zhr eml hwr ccv pwz qly
rdd: nyx eae zdb
boe: lmh idy afy ifa
tjp: dsk ezy
dyo: xnx jac
elm: cgy sve zlg bpt vyp znz bzf jpy sqm
xkf: cnk nvz dyk ied upm yig ypp yqu tmr
pgm: dgp exl ori bah
uou: qhu fnl dur
inb: uac vbo
fbj: uqe jei rwl tjv
fsy: mbd kew qix
wnc: tvo asd vua hti wru
ivh: xom hbb yrj gkg ngu
cko: prh fcb beu
mrj: xjt uqy gal vyj axs
qsp: fyc
tnf: ltb vzj rgh wyc vpl eza avr bps qbx
ybb: dfy bpt seo
uvp: zlp dna utp bow zst
uai: kju mpl vzj
yvj: vwx dfb jua gev
rfj: bbm pat tqc szt
rns: qzq ndz
laf: hju dss dnf yao
rle: prm xff iym qgl txg
nzb: cko mcx zal syf yed dwl oxz fmk gpv
grh: ldu ryq tlx vsu
fkx: lez
tli: ipg owp jrf ruz
sbv: chd vis nln jmh
qbd: owj mve nyx ehn
hdr: hrs csy
rgg: knw
ehe: eae dcp aho oua uqe usr
tct: vpf fdn tgs nln
oix: zgi
zky: kbo wxu cge psi ubq
izo: yfc ikt qyn
vht: csi uiw jbx hgf
fle: tqc ged guw qfr xqz bpj ida
wdn: qda vfn zli jim plf hwa
ahi: lpi deb bwp nyl mjb
ied: dqt yog npv mrj
uul: bps hat rbv vab owj
ksl: qfl xah laf qlt sve ugi
uur: vvp
fra: qoo wbh gku ayo ffn wup tbu vpt
dnf: vlk
rbm: fkg voz ddj phc
fmk: uac rvc vqx fbi
fim: mwe poh gla nxd sru end
vef: pkp gkj
hjr: lzn
syv: iij dcp sll dkz cxh
qso: bqo cge fyv gts fsp zgj
sys: sui wms sts
wai: poh gbd
iup: olc vor tph ffj igd ipx jie
lzo: bcb qka yqm
nss: qtm yza
qvc: ipl fdx jbk puu vlc tgp
avr: tnf hma fzb wmi
bec: hha wmy juo ymg nbj ckp fcf
xlu: wig yyt
fod: naq ijh bgs qjv btj
ssp: mhv taq
apu: vbo qrc ydc fwl cko
wrq: kmc
bxx: jmx axs iyf zsm tmr afy qac
ezq: sll glg nym oqe
zbu: gxy wzn xff ooj kzy
sgg: rkb dqt xor qax pqu uii
tou: gog iql ysk hnq fdx pqt
tiy: taa kpi tfi
fki: wkk xxu rdd ehg gyn ovk sys qrc zyv
dpv: ebl fgx
zab: nci
kzn: iql fls bmv
wms: rui zli sys xnd
amv: lro orl ymx drc krj llg bcl
chk: ggk pej lkj dub
ndz: pua rns xce
meu: ovl tva mzy lak uxz hwr yzp zad fls nyl jfj pcf
zif: lal qlb xkm udo uii
ori: rcr nvw pgm
ccv: ucx ujz
tph: wfe yow ilh
wvn: ehp yed obt sia zvs
vgf: fce ydc jua kju fqk htr
ugt: oqe zal oix
qtt: bmz ryq
chv: ggk moj ifq
uqe: pdl vnz jef zqc dpv ehe
niv: egc dax lju
nwn: syf htr
ots: rvk iig wan pdg fha miu
neg: xku htr esx ftx vye not
omm: ffc lgb
mrp: pax ikg blv epx ebr
cop: znz ebz qax ujp eoh pib caz jgt sck bga zsl
rou: qtm ohb
sei: npu blj usn sgg znr jhc lpi
ifa: aqa mgw tlu zob
gmy: iji fxz hha not mpl
eaa: yxg qab oee qrr cvu ywe qac
omy: lkc rqy uua
bbf: pyw ezy
ymy: bow aux njw cbu vjq
bnp: fyv dss col
tlx: mgw
alo: dvu fyx why ayu yxo
ftc: xvo bfd ufk nwn
epx: urc mrp ktq fqd vyf qlf jcr
kaf: rwg hur jxa
ney: wru lfj beu qeq nww
hba: kqo qix fpg vsz xux
vvv: uen oxz
bfd: gxu ftc
hrs: qzq hdr sji vor nbk pch ebr txg
iig: qeg wsr das
nij: pfe
typ: bmk kam fle xom rkb
fst: ehu sqq aub yxg klb jbx fvx zxq iem
ccs: atp dss dqd tfi
nrn: kqo xom spf vax ccv ivs ufe lni
odr: orj
wfn: htr npm ycy
ayu: qtw ktb ymg nbw tph
spr: shl lve mfs
sqo: axe wyy sns mii
lfj: yfc cpu
bmb: tfs eda kdq nks
tih: vpe kzi
bpe: rzw tje vhh whn afy yvs kyi
fiq: idy xth
poh: bot ckc xku wai zvr isw
krj: amv cqv zmu wiq sat pcb
bsa: lbn vov xlu xff
voa: uhs rzw ran
qeq: sct cvb awn
csk: vzy uhd wmi lea jef
gjc: lmp sxn
vaj: irn ezy mwu
ais: xau vlk pgk
bwp: ahi cfw kjq
tty: jtq
yuq: aff ptk qcy tmq lww jgz
npu: sei
chd: xku rcf txk
onu: zba zvt
pmn: igp goj bcl sru ywi jjd ktq slh
hhd: bzf wxu seo tgp
qfg: jpy ijz och fgi jtq gay
mwq: hcg axq hnw chv zoz qtq
lxr: tsg sjn fin
qrc: apu rtl fki
jpy: dxb qfg
eqe: kju srv ujy xaw sts ylv zli
twl: uur imj des lgb ysa
cyn: csm zcs igs isc ruk exl
zsl: pts tvu cop wgk
cbq: luj dij
bqo: uwi alc elx qso wgq wgk
dij: tst
jov: rvc mvg oda
mkz: psw isc
wur: moj fxb
dvu: ylv acn urc zyu end lbo uce alo
gvp: cgy qaa fdx xyt wye
tni: vsw ccv qeg bga bmo
nzi: spr khx ikg sui
set: fua nsk wur xsw
scg: wig vcg
lxy: kny yse rsr kzn
qvq: erb uiw
wrb: hnq csg
wcv: tsc xku ijn qzq
gyn: fki qzr zst qja rwb imc
jfr: blv pug hqr yos jxa vov
znz: dgp zvc elm wsr evd
xqz: fle qcj qns smz
ezy: end bbf tjp
miu: caj xxx vly bga gyt ots syp zoz
frg: qel mbt qoj
jfj: gus gog qpe npv
yoz: ltj eel jmw
xvo: kud wbm zal vab vyf ftc
gra: jpe
ebt: hrk
egt: vvb afy eqt
ipo: lcl hha ucz sia
sat: wnj mmd njy
jis: ljl suy pat fxb rwm rrq
hcg: isc set jyw gkp
kaq: vye oio pvc kvz wcb fra
stm: afl smd
evd: aca cio
kod: ykr ehu nih taw
qoo: hcw vvv idu fra hqo nbj mwu oho
xnd: ilo lea vbo yed ska fca wms tct
jua: yvj dxh sfi
rab: xmd muv qnw
oou: ebl gwq
yjr: hmh ooo rns vvv tpr ugt ikg yqm
bbe: rvk qrp rwm
wfe: wje tph qgl lea vqx rok aqd sit
kjh: vht boe qwv ksq omm owp kkf fcg
hqr: bzh vrt
rqy: cbu rns qvh kxo jvp ppr omy wmr
xxx: mrf ssh xau
sqm: fin moj lyh kjg xor
lcl: yun pkp nbw
ygg: oxm lac mcs ktf
qpe: fiq jfj ecf ged hbb
ymp: vxb rre
tgp: gay pwz qvc jor
fls: qwo akp ijz meu
obt: rwl
yow: owj fuh yzm
fdn: cbr zvt dxh uoa shv
ivs: phe vlc zjf wqq zgj erl zij xac uhs lyk ctv nrn
wxe: fyc atg ohv jrj
ktj: jei lbo amk hap
wyc: edp omy luj gwg lgx xlu vqx orl ikt stt
bfc: kug zgj jlt
mcx: nzb gbo qlf yed
hap: cdm ktj yyn
bow: prm uvp ymy yun ngv bwl rso cej nit uou
nki: whg njw bfd
rwg: rwj kaf yop qka cdm zyr bzh
txg: zvt psf hrs
pzt: kjs pcb fmj sep qda
vsw: frg ixf rkb fha jmd wqq kjq pfe ydj tni
kwb: lpi znr spf skq rkb
cyu: opp khx
dwl: neg hqo wig lbn nzb srg uhd zsk
tbf: hwr gwk znr omm csi
ijn: bfd whz zmu wcv
edp: juo wbh njy woh
vfn: wdn vaj olc dcx ncy
ucx: ccv aix afg jpe
xux: mhy
bfe: ntx akk oaf umy qts
rtl: qrc not
zvs: ffn yxy
btq: kkt qcy
fuk: dss xsw
ujp: the olp mgw cop ter uwi vsz
fbs: lqw
ikg: qdz yza
bng: cdm nbj fxi
ijy: oix xkq gku rtl sia
ruz: tkq ppf gra
zqs: eic zqo
yec: htj jmw ikp egc
vik: gpd msn ubq trp
dur: khx oab vuy uou gmy
hbb: emp dku psi ivh dqt vqd
xac: ivs ind mbd zmt kgl pdg
shv: fdn zuu
usb: vte yed gcw jci
mjn: cvu evd tvu bmk
oqe: lly uen ezq mva why ugt
voz: rbm knw zcp dqg not lkc
cgz: qqy mzp pvx
tmh: zbp hgf the mlm iza
ftx: njs
iyz: wyy rpn gzp
zoz: gts qll yxg hlf rtf
tyo: csm okr wqq grn
ujl: caz gus
bpt: qll elm eoh ybb
nyx: hdj sns mms
osk: zmu bum mzb
wgk: czr
ovl: fyc
mms: nyx dcx
vpf: emb pmy qqy utp tct
mws: lzn zij lcs udh
dqd: ccs zgj
fjg: rwm hju blj tom
jpc: cxh wvr dxy zvr
ebl: oou stt dpv ijh wra wms
moj: sqm wur rrq
muc: bmg mqv mws jom mbt
gpd: xgd ybw uia spf vsz hxb vik
qzq: lly gjd wcv rns oab idw fnq hrs
blj: lkm ths hjr
cdm: bng axu rwg zal hap igp
pch: zal hrs mgj
pmz: vuu slt ayo fyx rok jdv
kzi: rpe tih
web: qjv uhd
kiq: gcw yxo
npz: quu bmb zmj
srv: tps eqe
zam: wwz qih ldu fmp
nus: pcm jfj bkp pvd
wox: axe nym uiq cne sia
bqr: zmt ida dnf jom
avv: csg
ysu: rtm slh npm vow vov cbq skl
ind: rnz ykr tlu sqq isr gky lns nho xac fyv mzl
nvw: tvu vya vjw
lgx: vcg wyc xce
ewx: jtq smd zrc syp bqq qns guw
pat: hgf rfj
gbo: odr sui ayu lfo abi urc mcx ilh
fvr: qvv hxx tgs lqw amk rwl epx
sjn: vlf lxr hjr
qrj: tct epx obt fim cjj mms
lgb: gkg twl
qjv: tvo web
ywi: pmn ehg
isr: ljl ind
ywe: sfr eaa xqz pdg
lvt: ter erb qtq
xax: zrs pat
olc: vfn qbx jfg vzj
end: fim ezy
zlg: hju caz fgv
lzn: lvt xeq gyy hjr bcw owm unz mws fpg xjt
szt: nus rnz ayq trp bnp rfj xvx
esx: ioi shs
tps: xoo ezh srv vpt idu mfz
mzl: gal jdq msn fyu jmx
ezh: sui lbm umy
oxz: vvv
fce: zuu
jmd: vsw alc bnl eyy pda kbo
iij: syv ilx csy bbf
bah: bbe eel das qih
uiw: uhb
cst: yog ltj qgc ntn euf oee bzf zbp
quk: vpe tzn jcr wzn eqp qgl ezq eab
phe: inz
hgf: vht kam pdg pat rhu
jqn: zmt ipl uyk lcs bhd xeq xil
wqq: vsw tyo wgq
eqq: zvc fyv idy iql ufe xyt uyo
bdi: hlf gkp xsd vyj fha isn euk ltj bcc
xmd: wiq zcp emn
euk: bdi kug yla
hnw: kjq rzw ebz
klm: vrf fyx srv axu
aps: pyw qjl
avm: syv mms knw trr uew
jgz: hdr gjd uen yuq aev
cgy: elm
yla: enk xvx mhy gyt euk mdr ykg
orl: amv btj fzb wgb sqg acn
hur: gla
aca: evd owm oci ppf
idy: boe lyh nci eqq
xeb: xnw ami gss yoz lyh imj
trr: wkb
ykg: xlp zby eda lpi
pqu: uyk dex jpe aub
hzd: qvv kjs
mgj: rwj zws eab pvc blz xfs rtm pch but
rvc: rhl hit jov
pkp: fxp ktq vef
iat: dbq pua sxk wrh mtk jny hap
ocn: iaq ssh
vpe: tih vte
ckp: bec
lju: vvp
ugy: jrp vus wur mjb mrf tlx ulc okr cwf
zti: fua tpk csc skb
ykr: tqo kod ysg olp wds
mcs: wgb tih ygg
wxu: lns emp hhd
jiw: sgc ktq dus llg
zqc: uqe ydc zvr
vyt: mzp sns
rcj: yza opc eqj pif ydc hci ysu pmz
qrp: lmp hmk etm gpd gwk bbe
wsr: znz vjw gcx
lkc: vxh aho omy qja voz
xom: lmh ivh tla ter typ oqw sxn
deb: ahi exl
lnz: psi mnl pda naa sss
imj: hps xeb
uce: taz ooo
eml: ujz jbj jom
jbk: adj xth euf
vte: vpe hdr usb pvp
flt: fyx puo ska rui
cnf: gwk hnw yse
lvb: mrp gpn dmf wcb gbb nnk rzu
vhh: bpe qns qlt ymp unv aqa ddv
xkq: pxs ijy itc
mfs: spr gzp jdv
wvr: jpc beu ftx txk eab vua owf usd
yig: nij asm dnx lns
rok: ghw pmz blv
rso: bow yow blv
opc: ehn lve
txk: fcu fim ska sit pax rtl oua qvv chd txp
axf: jss afy
qvv: klm txk hgh hrs sts hzd fvr jiw
uoa: qja gbd scg deq bzh wyy fdn prj gpv
kck: ooo lgx vef ioi cjj luj
tkf: uls avv lyh udh ksq doe
rhl: zvo jgz vfs rvc fxp
tmr: mce uia
bcw: kny xjt pdg rss ffc
ltr: vyb gda owj wrh rad dyo
prm: llg bow alo won zdb lea bot zvt ney rle hxx
nja: vyp xnw ijz
bbs: fxi ktb eqj vab omy prh hap
ysg: epd ykr quu
pfe: dzj lpi uhb rzw vsw omr nij bfc
nqn: gbd eae oou mmd gev idu dmf plf
fbi: idu hqr ghe fmk
tvf: cnc oou taw puo
vuy: dur
tsc: syv ntx iri taz qyn qrj ydc wcv
mve: qtw qdz
imc: jxx qzr osk vpl paz
ruk: vqd lcs tzj udd cyn kpb owp
den: ari kad
fcf: pcb dna qlf bec
yos: qhu tzn vpl jfr yxy whg kth jov ilx yzm
qzr: vuu fuh dus
lro: amv yxo zyv
yxy: zvs kkv yos
lfo: pyw gbo rhj
sif: ptb mib ami oxr rxz xeb lor dqd ayp zam
xsw: fuk waz gnm iqk
pua: ndz jxa
rkb: typ iql
psf: eqj
ghe: fbi goj rfg rcf blv
usd: fnq pmy whd
wwi: fyu lqy eel
kkt: xku njw lly lto nzi btq
aol: gzp mve jzj vcq
kgl: aja
pcb: qhu krj
hlf: mbz zoz pos udd uyo qfr wrb
alc: bpt jmd lyh
itc: sju cvb
lcy: spf elx fkx fvx seo
zws: vow lzo bgc fgx ckp yft
skl: xkz dfg
owj: ltr
zgj: qso dqd fyc jtg gmy dku
ncy: vfn oio
stt: yft edz wyc rgb
shs: rvc pvp goa vcq esx kkv
ler: uia bux kgl znr afg bbm jor
oxm: rwl fcu zst ivn mwe ygg hzd
rwy: gdb goa
aub: ecf fst lyh
wkk: rtm wms fca ebr mcs ehg rhl
njw: ymy opc oxz nki sqo syv isv
gwz: vlf owm xax tzj
fij: goj fkg shv oio tgs
csi: jun ran
rzw: pfe owp yrj voa
ylo: oda vcg wkb jdv fjn nry
wiq: osx csk jcr xmd bum rwb
bml: mle uia naa pgm avv lju ehs
btj: ymx
ehg: tba
tom: ugx lrn gjm dtn udo
njq: zxq sve axw eel
vsr: kqo phe vyp ami ugi fdw gal
vrf: rsp urc wuw
axe: sqo vfs wox
wyy: idw slh fxi sqo iyz
tjv: ufk guv ney txg fbj
zmt: bqr csm zcs xac
fdx: qvc mla wpl
vzj: uhd axu mvg olc tnf dxh wpv
yrj: kkg qaa qax
ypp: aid kkf ddv nvz
hvs: lrn alc anz ran ifa jrp
vsz: xsd ujp
wan: vsz ult uhj jrj ots
rvl: yrj csc iza sqm kjg wko
vow: awn aff ysu zen msp ogf gjd zws
rre: wko ymp ocn ilm
gwg: yfc
csy: mvg jef hdr iij
ipg: ayq tli eqt vau mla zfk lrn
lbo: ktj sll bwl iji
awj: hqa gyt rnd axs des fyu
dus: oua
ldw: qcy ooj zuu mzb fce hha nbw itc isw
tnm: vik eda unz zlg
uqy: dxt kdq nho cge mrj zif pwu twp tva hst pvd
qns: vhh xqz ewx
bqq: eic fsp czr fbb
vfs: fgx rhl
gus: dmp ugj wko jfj zcd
nbj: bec bng urm
yao: guy kzn gue gog dnx laf
qjl: mxz aps whg kzy zqc den ohn srv
slt: nox zvo ecs fmj zyu
gay: qfg twp iyy dui tgp bga
ksg: euf iqk
kth: yos qtm whd vpt
nbk: rsp dxy rwb scg
vyf: xvo cne
kpb: ruk bwp avv pcm fyc
ehn: mfs gki nox tpr krv qbd yox opc mme
bmg: jmd lxy dzj suy lkj muc
zob: gss ifa lju xeq pwz mrj
euf: jbk ksg
vrt: dpm hqr
jlf: zgi ktq woh
zmj: gzn qwo qsp fyu
skq: uhb kwb
fxz: bps nww gmy zcp why uvp
vau: wlc vqd xgd sif ipg elx rgi
drc: taq kud mxz
yzm: vjq gev utp yow den goj pax yos
dyk: pag nqc yvs skq asm xkf wrb gss
mtk: iat sny juo jlf owf wbm txg
vds: axf csc dnf
aqa: tom ifa pvd pos sfr ysg vhh fdw
yop: yft vpl
gtg: hjv hxb pqs
qtq: xyh vya zxz
fsp: udu bqq
isn: bdi gpd unz iaq
xkm: iqv zif
tww: rhj yxo
dxb: slu jpy ikp xyh rsr bhv
kht: lkm zlg cnk oxr spf
yun: bgs bow lcl rbv
unm: iem bmk uwi ngu emp
qja: jjd uoa
vyi: frj wko hjw
xyh: ran uyk qtq yqd xqf
wjd: taw zgi wms
gkg: ivh npu uqy sqq uur lgb
fcg: ksg dub wrb gts msn
ohn: bec wtp xce vmr mzb hcw lac cdm bng fqd
sxn: lak gjc
uew: bgc gcw
tba: gda qcy lww ehg uqe xff
ivo: bot taw oaf zyr
gog: xyt xux jfj
ukp: ppx esd xiv fuk mnl egc
eno: rwb mpl gzp dxh kad
zpu: kgl fjg twm dub qoj dpc kmc col
idw: qzq zgi wyy txg
doe: yzp vik ulg
jgt: slu nge vik rhu gzl tdk
axu: klm spr apn
acn: qqy nym cnq
kug: rss qwv bfc euk sve iyb zqo
lez: fpx cvu mgw tpt fkx fsp
ftb: cgy dqt uxz sfr fmp qlt dui kjq
qtf: zcs zvc car akp wqq pej gyy
qac: qgc bxx afy
tue: qdz
slu: unp qns exl zbp
zpz: aux vbo nfk rwy qnv pzt
lvh: rui sts fjn idu jim tvo kho
pcn: ami zmt vlc pib wan
xff: axo rle
vcq: qlf wup
but: qps zcb nrs gpm
amk: ktj kfc qda wfn bum fvr lbm
lww: tba yuq hma
ikp: dxb yec mws gue
rwj: zcp vjj wje rwg njw owf vzy
sfi: ylv zoe zdb
vab: bbs uul
caj: miu tiy
ijh: qzi vpl
tqo: jhc qll ufe pgk ykr cnf rhh
zsk: dfg orj bow pzt pmn dwl dqg gwq ayu pch
khx: nzi dur cyu
egc: ulc syp niv yec skb
whn: sqb olp bpe
nyl: sss meu ahi igs
kvi: sru tih
afl: gue stm iyf qsp csm
mdl: iql ksg
ozm: xkm kqd uhj qix qfr dtl phe das nja
emp: evd hbb wxu ugx ouw unm whn sxn ngu
kbo: bqq zky dex mbt gzn htj dtl vta bah jmd
rsr: wur
cbr: orj trr bfd fbs dcp fdn cqv
lyh: idy
esd: uls wds
eyy: ksq axs tmr axq gjm
rcf: hma chd gjy dbq nwn tmq ghe
lkm: vus ymp omm kht blj ssh zjf adk smz uur
lal: mzl uiw yzb qly rhh typ ctv zif lcy nge
col: hjr bnp rtf
fca: guj
bot: tpr ivo wmy bfw sit mii odr inb prm poh hgh ayo wnj
sqb: whn the gjc
tlu: dex iqv dho
csm: tyo afl
osx: wiq eab qtm
llg: lly ebr whz prm jiw
nih: boy wpl kod mib
jrf: tli gra gky
wru: wnc
yvs: hjw dyk xvx
lru: vyt hat qps bsa rle tvo xnd
ugi: axq eoh otm mdl mzl
spf: nrn gpd
gjd: ntx bfw vow yow jgz qzq
vax: bhd njq cex
nsk: fua set
fxi: hmh bbs zen bng pkp wyy onu
xyt: fyu gog bah
quu: udu npz ysg zab tiy wan xyt
cgd: ltj mqv msn uhj rhu qlt unv unp ykg mle
okr: kqd
npv: ccv jfj unp ied atp mnl
pcf: dtn fgi ywe cio meu cnf yec
oho: cyu bgs uho
oee: fpx cio
vya: sfd nvw
sia: ipo aqd zba ijy
lac: ygg srv cgz nnk
mbd: xac eqt hjr fsy olp
ulc: fnp dui mdl pej egc
ldu: grh ppf gjc iqk
aja: mzy cvu
udo: ecf wye tpn ufl
taq: ssp
fxb: wur waz
sny: drs khx shl mtk
xsd: gjm ifq ehs vsz ipg hnq nvz qsp mgw
vsu: wwz grh zbp
uhb: uiw skq lkj trp tlx
vdj: rxz sjn
dna: dpm zen qbx
nge: igw eyj bga qns rvl zti niv
bmz: ezj zrs qtt
dka: gts uia frg aub gct
sbj: bgc qtm uep fna pmn
vwx: tpr yvj vkt rsp xbd ygg
abi: jxa bps
slh: ffn wyy
edz: stt usr
urc: gbo
iqv: axq xkm tlu
ayq: inz bux szt vve xju ymp ipg
lns: bhv wxu
vby: kjs dij wlv fij opc qzr wmy uua
hwa: idu zst paz
dqt: hbb voa axs zrc
egf: zpz pug dsk rtl mgj htx ucz zqc rfg
zxq: fst lqy
elx: yog gts lcy jss tpt
mwe: dkz rou
lve: opc spr vuy uai gdb
suy: jis fpg nsk
tpn: klb vly mkz
tdk: mqv
igs: bhv nyl
axs: gnm awj mrj
yxg: qgc gog zoz nja
yqu: xkf iql guw caz pej
udh: pcm mws rhh kdq fuk tkf
wwz: zam ufl
uua: omy shv ftu hdr
ddj: lru uai izo gbd sue rbm
srg: taw wva
aqd: sia vis
jcr: wiq yft ezq hti epx cgv shl
hit: kkv gbd zoe rvc tvf rso zen ogf
ipl: qvc adk
adj: jbk ezj ohv cfw
kxo: vzy ilx gpv jfg xbd obt
isv: eza pvx
qge: eoh udu yqd fua
wkb: trr nki nox uho yji
pax: ylv hma txk rok
xfs: ltb
ktv: nqc vve
mxz: qjl asd rso lea ptk
wbm: kad hqo zvt vkt ffn
vpt: jdv nyo iri fql kud ckp tps kth
zvr: zqc jpc poh
xvx: lni szt gct yvs
twp: rhh
puu: jun yzb typ lal nsk htj rsr kyi
sep: cxh ckp izb akk
plf: xce why
isc: gkp cyn uwi dhp mdl mkz jor dxt klb hcg
ggk: chk kes
emb: fmj kwe yox gki npm vpf
ybw: ufl yig
qlb: xjt vjw vyi fgv zif
jpe: gra atp ucx
hwr: ged kes
des: tfs awj jpe mbp
iaq: pda ubq ocn gzn pts isn
cvb: vjj qeq kth itc psf
sgc: jie nbj ehp qbd gla
dub: chk fcg muc nij
qel: uls rhu
bfw: sll gjd
qtm: vnz rou nss kth fna
gla: sgc jjd tst edz hur
rad: njy abi
ptb: yvs avv iqv
wmi: wes rgg jef
fkg: rbm jpc dmf
ezj: hnw adj ucx bmz xvx sqq
fql: gdb wlv zli vpt fcf gev
shl: sny vyb spr
eqj: bbs psf rwy sqg yuq mpl
iji: pdl ppc waq gmy gkj wrg qnw lbo
lrn: ipg aid gct
naa: dnx bzf dlg bkp
fha: ots uur lyk nih bbm vyp vlf idy
dzj: ydj pib rtf cnk
bgs: wcb fod oho yun fbi
pvd: uqy tqc qly
skb: dxt zti ter
kqo: kam nrn pts ujl yao lze lez vsr hba uqy das
cpu: lfj qeq orj igd xcz
nry: fbs ayw hha
krv: wra
ujy: ltb cyu gla eqe
ivn: glg inb toy luj naq
sts: eqe jra sys
tzn: skl quk rgh ovk
xku: chd cgz wcv neg pkp poh vjq
fnl: uka tue xfs cnq uou
ikt: izo ssp idw mmd
gbb: oio pdl lvb nox ycy
vbo: orj zpz inb
tpr: vwx bot omy bng
afg: xnw yzb exl bah ler chk ucx
qdz: srg obz ikg fcu tww izb qps tue mve rzu scg esx
cxh: syv
sit: tvo wfe lbo dbq rab jov nss
fqd: epx
uep: fmj wtp
vnz: fbi naq qtm zvr
glg: xcz lea ezq hcw
vua: rwy
xnx: lkc xfs okz wrv dyo but uai
axo: kkv jci xff rbv btq
gzn: kbo gay zmj egt iaq ipl
pwu: ecf zsr mco kam
pgy: jny ktq shv yxo
syp: sck lyk eyj ewx egc
yed: nzb rpe
agk: hst lmp pib
tva: uqy dpc yqd tpk kjg
wnv: vly rez ntn yog xkf zdw muy ahi
eoh: muc zsm jbj bpt ugi qge vvb asm
lor: fdw tpg
fwl: apu pxs vam qka
dxt: czr uhj wrq skb
rfg: ffj sji ghe qts
guv: tjv hti
rrq: moj smd bkp uiw jdq olp
boy: nih dui dtl hju quu mkk
goj: fij ghe fbs kjs
dmf: nqn vye oho lvb fkg skl
psi: hbb exl mkz jis qgc
qwo: voa fls car jbx yve zmj wgi zvc eqq
cgv: qgl xaw goj jcr xnt
qhu: zyr uou yos jvp tru dsk nfk pcb hxx cdm
uhs: rez bfc voa ivs gct lmh dfy
och: klb gct
zjf: lor lkm xah
pug: egf vov goa jzf jfr wra
owp: ruk dpc tli
cnc: axe bwl kho tvf oho cbq pvp gbb
qll: hee bpt wpl aja ssh
jom: bqr eml iem muc nsk
jun: csi asm set ipg qtq
bzf: naa hhd lrn
vvp: lju trp udo uur itw dgp tbf boy lqy
ktf: txp wmr oio zyr ssp
qwv: yla jtq dor udu
gwq: ecs igp oou
unv: mkk xil yse
yyn: wfe kbr aho fij zvt hap tnf ndz onu phc vab
hgh: qvv mwu uka ugt zvs pvp
wgi: fxb mle qwo lak gra vve
xoo: qcy pau bgc nww sue bps tps vrt
okz: grv pug xnx fod
ulv: rpe qts vqx vrt iri zbu wuw
afy: bxx axf uxu
wtp: uep qqj dcp ohn vyf zlp
woh: wuw jlf pmy
dfb: jxx aho mxz tph
htx: whz izb osk egf vmr
rhj: ezy zlp tww lfo rab gyn
znr: tbf sei ler
xah: zab sck rwm fdw ksl bdf hjv zjf des
seo: uyo yoz wsr ybb
sxk: njs yft vcs end
tla: wxe sqm lxr fyu xom
mbp: des kew
lni: ifq xvx vsu lze njq iem okr
ntx: nrs wik gev fmk huc bfe
uka: hgh igp
yqd: ifq uyk nci qge
qcj: xqz igs
wpv: wva wmi
tvo: fgx jfg qjv fcf dfg tpr
waz: kkg vds fxb vyj bmz xsw
hjw: kdq vyi yvs col tla jdq
bnl: jmd
fyx: flt aqd ijn
axq: sve ugi eyy iqv pej pqs
oci: klb csi yoz aca bfc xsw
aho: yyn jei ehe whz dfb oab nit
oxl: npu dku iig
lzd: mzp paz akk deq
jmx: bxx mzl
zqo: kug
iyb: kug ssh epd
qbx: blz ijh zst xxu dna olc
sfd: udd unz tnm vya gtg pib dfy klb ahi rsr
wxi: gtg cfw bdf ktv okr pgk ied
grv: okz uka rtm tst irn
apn: msp utp
luj: wyc cbq mva jmh
bux: ler dka sss usn zcs
cio: zxq eel mbp oti evd owm
iem: lni zij unm lmp zby
qda: osx ftx eqp gku
vlc: pcn qvc ymp
xnw: nja mlm afg bhd bcc xiv aix xeb qab
qfl: xbs xeq jlt xxx awu zby
qnv: wai hti
vyp: nja
gky: vqd
zcp: fxz qzi wup bcb rwj voz vef rok xmd
fnq: ylh qzq nox wrg
gxu: cbu bfd ayw njy ecs vye xlu
rhu: xyt qel rhh hgf cgd
rez: uhs epd uzw dax qaa
gku: deq dna eno ijy
kew: zsm qix mbp fsy
gki: uvp nry why
sns: zyv qyn nyx
oda: wup ylo
hmh: bdy fxi
zrs: kes bmz rvk xax ayq eyj
nho: vta ami ouw uqy gal gyy dor kny
vzo: qjk rsp vjj ezq cnq ooj jxx wrg
lkj: bmg qsp
tqc: pvd jhc rfj
mzp: cgz lzd nln paz fbs ymy vyt
bmo: qih bnl hps tbf sxn tni dhp eml aid dxt
jjd: qja ghe hzd ikg gla pmn jlf
sso: enk otm dzj npu fzn
ydj: vsw ehs etm
dlg: naa moj dss
sqq: bmv ezj
dku: zgj
hnq: xsd wgq wrb vve
jei: ktj dkz jxx khx wlv kvi beu aho
kud: xvo naq
cvu: aja mjn smz elm fzn vvb lez dqd eaa
rgh: tzn jci tnf
umy: ezh bfe
wds: ykr xbs esd gjc
igd: iup emn zbu vcs dkz
qeg: wgq fkx mbt akp iig
rwl: mfs cne obt dpv
cqv: xxu puo hur
tbu: lac qlf yqm ycy ktj not
ebz: mvp cop ixf ugx
mpl: eza oxz eno lea bng
dor: alc nho dxt qly qlb qwv
jlt: ppx taa bfc qfl fls oqw
qtw: paz dfb ayu mve axu yfi wmr xcz
ayw: rou vcq rdd
blv: mrp jfr
dpc: zpu fpg cnf twp owp tje dtn
cej: orj fca lsc
yve: zif xux zrc ksq ulc fzn vta
igm: yfb qyu ssh fgi
qaa: iyy qih jrf yrj hqa xor fin
nbw: tue lcl lgx cnq
rvk: nus vsu nks bbe mbp lmh sss ots ysk
mib: nih xbs wko dhp
zfk: qyu yzp gtg pqs
uxu: ixf bmv nks afy mvp wrq xju
rxz: zhr zxz iqk fvx
bmv: ebz sqq qcj jrp
mle: uxz uqy wgi bbm zxz bml
ilo: ndz ppr qqj nbj
hat: lru ilh uul wva
qyn: dxh nry aps gda sns
hqo: dfg dwl whz jim
zba: xfs sia jqi fmk sru onu
ktb: owf ayu sji ftc bfw nbw ssp
fbb: itw jpe qvq ehu bqq mco sgg
pvx: blz cgz
uen: hur jny nki mva vvv
gns: csc mlm
rsf: zmu jxx shl rbv zdb
gjy: ohb kjs
pif: gdb wzn lzd nxd ogf
aid: kqd lrn ged bfc bmo ypp cex
yza: nss fkg nym
wes: wmi njy ikg aux mii isw guj cbr ppr gxy kzi
bdy: csu fqk hmh qqj uho gku zvr
hdj: ffn nbk tct nyx klm kad
dtl: ozm ecf xiv
tvu: ijz nvw mjn
iql: yqu kzn otm mdl
rwm: aie fnp
irn: vaj qvh grv
qlf: yfi vcq
pqs: gtg gjc zfk axq zsr sso xqf vta
wmy: bot
aie: rwm fjg uwi kjw tli
smz: cvu pos bpj dku xqz zlg vax
idu: fbi llg qnw qoo lvh tps aff fqd nqn rui hwa
rgb: jzf rgh ijy stt slt uka
lbm: gev amk ezh
xce: vcg ndz
uxz: isn udo qcj xau bkp mle jtq ida
lze: lni hxb ppx kqo
ugx: emp ebz uyo cgy eel
dxh: qyn eno dxy
xqf: bpj xyh pqs
waq: jzf kud wru iji
sve: njq
qih: bmo nih qaa
pau: puo mii
fjn: apn rbv ylo qjv tww wru
dqg: uac
xeq: mco
hrk: ebt upm mkz
vve: ayq hnq vyj
kmc: zhr wrq jor vya
xcz: wrv wbh inb lep nxd cpu glg
wsc: vam nbj rgg dus cgv avm hur
eyj: nge znz oxr zrs mdr dax
rcr: qly caj ori gns
fpg: hba lzn
dbq: eae okz jim
gxy: amk wes mtk zbu
ecs: gwq eae gzp vyt
yzb: lal yfb mla zqs
jrp: yse zij jrj jtq
aff: qvh vow awn
mlm: tmh xnw dka xau gns
ptk: cbu yuq skl tru
kjs: ioi vby
gcx: mce ami tty wsr
iza: rvl aub rgi tmh
itw: vvp xor fsp
rpe: imc yed oxz gwg umy jim iym ulv kzi
zuu: ldw uac shv fce
jac: yxo xce urm akk mvg
wrh: ltr odr usb vvv
awn: cne qeq
eza: tnf kzy mpl isv
isw: wes ldw
vcg: scg vis lgx fqk xce
vly: tpn miu gyt
ooj: tjp yfi dxy ivo zbu vfs
jie: iup vcs
gqm: zyu bcl xce
pmy: wig yfc zlp akk woh
ftu: wje wva yun qda lfj nyo uua eqj
prh: bbs cko csy cxh ufk wnj
muv: cxh wik
fgi: igm dmp
ufl: ybw wwz csm
jtg: wye zgj ovl zby lrn
taz: wra hci uce
wwg: usd mcx vua axe aho
ipx: vls iup
gss: xax qoj hhd xeb dyk
jmw: yec
yse: unv jmw zxz ruz lxy jrp
yfi: ckp qtw
dib: xgd qgc unm hba seo
jxx: jei vzo
iyy: iyb niv ijz gay xqf lze dpl xeq fbb ysk qaa
sqg: eqj zgi xlu
dho: bzl jyw
ppc: iji
udu: fiq tkq bcc qrp fsp xgd qwv quu qge
wbh: fxp xcz edp eab
fgv: fyu qlb
bgc: uew jvp sbj
mhv: ssp fod jmh yji jra
csg: avv ohv ubq wrb rhh zbp wlc
kjg: tva sqm
uyk: pqu gjm yqd
guy: klb ter jpy bux iem ccv psi ult yao bmv hxb ufe
soc: emp dex unz npz
ghw: ncy jzf rok qqy zuu
oua: ehe pcb dus jie lgx
phc: whg aff vls rbm
lqy: frj zxq niv
guw: vxb afl adk fle ybw
kju: drs irn jvp vgf uai
olp: rrq ykr
ari: wfn fmk bbf csu den
lep: dpm dkz xcz
ayp: wrq sif
zyv: vpe oou hha
kad: hdj taz den
qrr: pag xjt eaa etm xyh bwp nja hvs jpy
wcb: lbn lvb
kjw: mnl qgc yrj tlx
unp: slu ctv vyj cgd
mco: nqc imj
ijz: tvu
uac: ovk cjj inb gwg qqy fmk zuu dqg
bpj: fle
ran: hvs
dss: bnp qfr fuk frg qel udd osb ccs dlg bzf sfd laf
zfi: yla isr bqo ryq psw wan
mii: wes sqo pau
lea: prm glg
qix: yqu tni fsy ozm hba kew jrj
mmd: nqn ikt
cge: uqy hst iig
kzy: qjl
fcu: qdz qka txk
ter: ujp skb guy
caz: yqu iem uhs ujl zlg igs yog ebt tli
ohv: fle vyp adj wxe fxb kjh csg zad ggk zxz
fcb: isv ckc vis
taa: kes dax tpn kkg tiy
fmj: emb slh uep
vus: zrc doe ugy vya
pqt: atp dku yvs
mdr: bbm osb ntn isr hjr
wrg: vzo fnq rsp oho luj
pgk: ais yse grh hee
ppx: miu jun jlt jrf pag lze uxz njq axq smz fin
dex: jyw pqu tlu
sck: hjv lns vdj wds syp
unz: tfi tnm
fnp: eda rwm rnz guy wgq ulc vlf xiv das
atp: npv pqt jpe dgp
box: qrc mfz jpc rpn lcl qjk
uzw: hst trp
jvp: tru bgc
goa: whd aev
psw: ktv mkz tfi fgv
lsc: uce cej vxh end jdv zvo
bhd: vax hvs qrr jqn xnw nho hcg qlt dnf
eae: nqn dbq
hee: pgk qll mzy gjw pda
wup: vcq mfs oda mwe
cfw: qgc tlu bwp dnx adj
ufe: nrn msn tqo
jbx: tty twl och kzn vht fin
inz: ftb phe psi ywe olp gzl ayq bnl sjn
lak: wgi bpn
pej: yqu jyw
xth: wlc jbk fiq
fdw: xah lor
won: aux prm juo uhd pvc wmr
ljl: fdw ayp aix isr zvc gcx jis mla
rtf: tkq dzj
nit: msp jfg
dgp: tpk aja atp vvp csc pgm znz qac
uhj: ozm vvb zij
gdb: fql lcl pvx waq rwy fxi
lpi: pfe kwb
not: tbu cjj rtl
hjv: mhy sck zky pos xah jmx jhc csc gtg ctv
gkj: pqb vjq rle sct vef
xlp: lcs kht ysk muy ykg vjw das rnz zdw ayp zoz
jef: opc wmi tww
fna: vrt qtm wgb
fzn: cvu uhs zxq
ulg: doe tou qtt chv kwb uyo lxr
wig: dwl xlu yft pmy kvz scg
bga: euk ysg gay cop
fuh: vcs drs dvu qzr dpv yow cko
ths: qcj ahi hee wrq erb blj kyi
wtt: jtg adj aix lze zdw
qps: qdz orl lru urm
oqw: skq mla jbj jlt gzl
zrc: zcd dqt klb vus
bpn: ffc ais och qab ctv lak
bhv: gwk igs lns fkx
msp: why nit ycy pdl ebr apn
igp: pmn gwq cdm
gqv: aca zky kwb csg bcc xil xux sss pyh
ymg: csu xkq bec srv
nci: yqd
gyy: zqs qtf lzn
oaf: qzi
tpg: vyj rnz hst ilm lor cwf wye
jci: axo wzn rou
wva: uen jzf ftu wje srg mms hat wpv kth
qlt: bhd vdj tkq
nxd: fim ehp
ktq: epx pgy hti pkp
fyu: igw awj zmj rrq mzl xyt wwi xau fgv
ylv: eqe oxm pax sfi bcb dvu
kes: zrs
vjw: pcn xlp qlb nvw wsr gcx tom atg
jfg: tvo wai pvx nit btq
udd: ruk jor
beu: jei wvr zen
kkv: axo yxy
sce: egc kgl gyt mhy wwx eqt egt zhr
opp: wlv tbu cyu nww lfj cbq
nqc: ktv yxg jhc mbz mco tpk ruz vly fmp
jhc: sei tqc uzw
hxb: guy gal sqb gtg
blz: nln kkt kbr phc qbx pvx pif
whg: yos nki qjl phc neg kzy
wgb: fna end orl
fgx: sns vfs dpv
zdb: sfi zoe prm
jss: hju gky
mhy: sce xux
hju: gzl laf boy imj fjg ilm kmc jss ugx wye zlg
lbn: dwl wcb
ffj: cko vye prj rfg urc kiq
pvc: won kaq
ioi: kck kjs gpm bdd esx
csc: frg hjv zti yec gns vds
hci: ipo qgl taz rcj
zhr: sce rxz kmc tty ysa mla ujz
tmq: oda pmy nnk yuq nzi slh
zen: hit ywi beu
ymx: amv urc btj dcp juo ivn ayu ioi ovk ooo
pvp: aps hgh hmh
jzj: zlp gpm guv aol nrs
kfc: yji wkb psf zyr gda
nln: blz
wgq: bqo ngu
ppf: mbz lqy ldu
vis: itc sbv vcg aqd
jny: rpn iri iat kju pgy uen kud
prj: xkz vmr aff whg vor yft
vvb: uhj ybw
oab: qzq aho fwl okz uhd
hcw: ohn zli iym
nym: wox yza lbm
kny: iem rcr bcw igm nho lxy cex cwf uia lnz unz
gpv: tvo kad wje
qzi: wwg nnk vte ijh oaf zcp
yxo: kiq vuy tww jac pgy lro
wrv: syf rdd xnx oix
ngu: jtq unm
gnm: bzl vax cnk xsw ouw dho axs tom qoj kyi
oio: kaq ncy pgy asd fij
vxb: ujl ymp guw qtf jun gnm
izb: htx odr sep
jyw: erl dho
uyo: hlf
nww: ney vmr
qnw: ltb rab
wzn: pqb jci lbn vor zbu ilo
asd: csu muv oio
qgc: vqd dib psi qac yxg cfw nus cst
fyc: kpb ovl zgj
qvh: eza emn aff blv zdb nfk xbd irn
ska: xnd yyt txk ckc flt
lmp: iem gjc
bzl: dtl nij pwz suy itw dho
dfy: xeb ybb oxl
omr: rss dqt lxy grn
bum: osk
ecf: udo
igw: och fyu tty lju yao nge
zst: fxp ckc hwa uvp qbx
dsk: tjp nyo spr igd
rpn: box bcl oaf ogf jny iyz kvz
mgw: xsd lez tlx
mrf: wwx euf fle gyt xxx gkp skb
fvx: ldu rgi rxz
ilm: ugj pat rre znr dib
xiv: fnp dtl ugj
zyr: qhu kfc
ppr: xxu rqy wes
zvo: hap rhl vpl pch
grn: omr egc tlu ubq
pdl: uqe gbb
vjq: ymy pgy mwe
zcs: cyn ovl qtf
fin: sqm ppx tih
nyo: ftu aev
tzj: xkm
drs: fuh toy
vqx: ulv fzb pqb
ugj: ult iza kod xiv gus ter gra tnm dxb xqf xil pfe ilm
fyv: bnp erl kkf qso dqd qwh bml
njs: sts pch ftx sxk hxx yop gxy
car: qtf pdg rnd twp ubq
zlp: rhj jzj pmy psf
rui: flt dur wms csk ntx shv
wpl: fdx mbp
msn: ufe cgd
gct: xvx
bps: tnf xoo wje lro
zmu: dfg rsf vis qvh krj ijn osk lbn web wcb
wye: hju jtg
ylh: fnq ebr qtw ygg web
vlf: fnp rss fgv nyl sjn gwz
hma: cnq isw
pts: kqo ayq oti iaq bmg zsl wwi
pos: ais hst aqa hjv
dmp: awu mkk gus cib fgi lmh qwv
xor: itw
ilh: hat wlv gbo
qoj: gss bzf uxu gnm mco frg
vzy: grv qrj csk rwj kxo hqr zvs
cex: vax mjb uia
naq: fod ivn isv mvg ilo kud zgi vnz
vam: fwl hqr qbx tue qrc iij
qqy: vpf cgz acn
xil: ugj gqv
zsm: bxx kew xux ehu
hqa: dtn tdk awj
zdw: wtt qsp gtg wnv wwx
ltb: ygg ftu oua tnf qnw ujy dcp xfs
vye: kaq neg dmf gxu
dpm: emb zst dna kfc not lep rhl vrt shl pyw kzy
yji: mhv
zxz: yse uzw qtq rxz gue
iri: vpt nss
txp: ffn ktf
gwk: cnf mkz nci ntn hba vta bhv
gue: gjm afl
gts: qso zoz
deq: edp gxu lzd nln uoa gku sbv rbm fki dur
eel: wwi njq cio bah ugx
fqk: vcg jqi wcb
paz: lzd rwy huc jzj hwa imc wnj lly
njy: whz nss
vov: pug sct bsa
sct: fcb stt qeq bcb xvo gkj ppc beu wmy vov
csu: ovk ymg kzy usr asd
usn: dlg ybw dhp wur bux pwz qac wwz nij chv
mme: bps vkt yyt ehn pdl vcs lzo
vxh: lsc ppr ydc qnv wpv lkc
aix: ljl whn xnw
emn: igd xmd qvh
ebr: mrp hrs
gev: ckc yzm woh lbm
awu: yfb vsz
sss: gqv
das: kqo ozm iig
qwh: ocn nyl fyv hhd mlm ida
tfi: unz cib mbp tiy
ixf: uxu vsw
pcm: nus gkp
rss: erl
pyh: owp gqv uur ksq pag mbz bmv
lto: kvi njy ghe kkt
nrs: but
xkz: yqm oda skl xkq prj
rnd: awj ebt ovl zab smd car
hst: cge agk uzw grh
dfg: skl zsk hqo jqi zyu emn qka
exl: psi cyn deb bpj pgm
muy: wnv gyy zjf
fzb: akk ffn vqx bum
iqk: ldu xsw
vpl: yos yop ijh
yox: qcy ehn dcx uka vyb
rzu: xnd xkq nwn cjj ucz qdz
wnj: sat bot paz
qgl: hci rle
jdv: ylo pmz mmd
upm: hrk tpt evd qyu
czr: ebt pdg wgk hps ppf suy bqq dxt
asm: jun lgb yig wgk dyk eoh axf
xau: fyu
syf: ydc wrv nwn yza cne pug lcl ghe vuy
gzl: jgt inz hju oqw kdq
gzp: eno urm aol ecs
rwb: gyn ucz
sji: obt rfg scg kaf
eic: jpy sqq bqq cib gal suy vht uyo zqs iyf zfi pcn
uii: rfj sgg uzw xbs jdq
wko: hmk mib
wmr: mzb won rqy ehg
mjb: ahi dui oci naa cex
rhh: lal twp
ogf: isw sui csy hit ohb rpn htr
pyw: lac bbf aps lfo pqb
vyj: bdi waz tpg mrj
epd: ysg iyb fgv uls akp
yyt: xlu
eqt: sce
ysa: kdq esd ddv ori twl zhr fmp
gbd: ddj uoa wai
sfr: ftb
anz: wsr hvs agk vyi
ubq: grn iaq car vik csg zky
tpt: zbp lez upm
gkp: bdi pcm hcg mrf
puo: flt grv ioi aev pau tvf cqv fnq wcv
aux: ymy wes
bzh: rwg hqr zvs
owm: rxz aca ebt
orj: zsk cej odr cbr vbo
kjq: bwp muc ftb hnw
vcs: sxk kkv mme igd jie
lqw: fbs pvx fnl ugt sqo vye cgz
mfz: dcx box
ckc: zst
mkk: unv dmp fvx ugx bkp boy rhh
jra: sts vuy rsp
cnk: gnm cge
sfl: jfr qrj usd nss oda rsf qjk iyz ipo
bdf: ult
mbt: frg bkp fin
nox: taw
yzp: jbj vsu tni zfk doe
akk: jac
ida: uxz gjm qwh skb bqr
ysk: caj uwi otm bnl elx
eab: osx ipx mgj quk
vqd: hbb ruk gky
gda: tba kfc
jqi: ijn fqk yow
ged: hps ufe dax xqz hwr
lmh: rvk gct boe sve uhs
zli: wms aqd
viu: yvj srv sji
qfr: fle ozm
ami: vsr gcx
jim: zoe dbq lvh hqo trr
oti: vdj cio ufl tpt
qts: isw nwn zal vuu
whz: njy
whd: usd goa zoe pax kth
fxp: nxd wbh nrs web olc zst muv pkp ehp rhl
nfk: zpz tps rns huc qvh
gyt: yla qfr miu
pib: agk xth cop blj dzj
eqp: bdy rsp ecs qda fcb
htj: yec ssh puu vly
vkt: wbm ywi ltr
yft: zws ooj woh wig sxk fqd yop stt
pag: pyh vdj iyb
ltj: tzj yoz
yfc: lfj gpm xaw nki pmy izo gwg
xjt: qrr qlb bcw mrj
ehs: ydj cwf
guj: tjp fca mve wjd rgh pua zvo
zyu: dvu jac wcv gqm
rnz: vve szt ind zqo dhp ugx nci tpg
ult: dub wye wan vlc whn ugj sfr bdf qvq bmk lmp
bmk: wlc xqf typ unm ult rcr
lyk: udd fyc ovl ddv syp fha tla
cjj: kck not
kam: zad pwu vya
kwe: vte gkj zdb jmh vyb xcz emb
pdg: bcw pqu ots
qqj: wtp
tru: jvp ptk uul uho uka qhu
htr: ogf urm
zoe: jim dqg sfi
yqm: tbu xkz not yjr hma lzo yxy
jxa: oaf pua abi jfr kaf xce taz urm
ooo: yjr
qab: pos xnw jbj ipl
fpx: psw oee mbz npz taa zcd
toy: sui drs csy ivn
wuw: woh
pda: lnz hee lkj unm iaq
smd: stm car jrp rrq ewx isr
tsg: lxr twp tvu zab avv sqb jbj
jtq: ngu ewx
zcd: osb zrc gus lcs dqd tli fpx
ffc: bpn hps
dcx: mfz drc aev vfn mms poh wnj yox
trp: uzw nci vik uhb tdk qfr
vta: boe htj yve suy
ydc: rcj
pwz: zob usn
yfb: bcc dpc awu yzb igm
kyi: gnm jfj lns afl
rbv: yun uul bum fjn oix
mnl: lnz kod kjw ouw
sue: aps vuy ddj vpe vkt
utp: yzm apn
kho: lvh nrs cnc wfn
ssh: igm htj ocn xxx
vjj: rwj ckc xnt fce rad
mbz: nqc pyh hlf frj ppf
mzy: adk hee pwz sxn aja
wlv: jei ohb vby ilh
pxs: fmj xkq tst hur nnk tjv zvr qzi fwl
pqb: llg vqx dyo gkj qzr axo pvc
ouw: nho mnl xjt emp yxg
mzb: wmr osk ohn mms
