gjh: djb gyc pbb
hml: dim nhf drq gwl tfc yew prf xiw
hof: ldt ysk zod xdr muz zbt vum jxe
iuq: kzo qpq eqs sgi wkv uts ydd
pef: lpl nlp bxp uah ubq vww nxk
cns: uam cqx wtf qhy
kqs: mqo pqm aso
xxa: uxb cuo dpn kjl
hly: vum sys zio nza qsc dyz ycu
pte: yss wdq csj hoa hcl phq
zlf: xqa gzt xdr jqu
fjc: plh jyk agq ylx nnx
xoc: rql nxk
seh: yqm iat
ter: vxt qri vbh
jfh: exe
vsy: nak mkm beh gjh
xor: noo vbh opk llc
hms: tzm ojt bam
tkr: egb qdq ygk gcf bwg
hvq: aak ugz gln krm
lwa: bih lix
mon: xiw zjg sbm
zsw: txe nbb hjn pkw vzo dlh gdw zag
svx: tno gsf hvq
gyf: uuv dch zwp lvw
zxm: dyt vtw
yzt: vcl jzq
mnx: uxc lcj cvz
soe: nsu gwz knh bjw
mzd: itq ufr bfq
nbb: vvr ljb pdn
lqr: tag srg pkb ixb
yai: yth jvj lix opx van xtc
kto: ypw cox eub zyp bkz
map: bjg jdr
yjx: prf igp ssc opq
bgq: lzn pgf pug gfy dcm kyu ajx dcx qri
jxo: jmc jvj nfo
qxg: gvo hyc gah hxx kov xfi
qvb: nlm pxz llg crq nrc tmr kfu
nkr: jva oco tno eps rgx ccb sun
lzf: kkp wfa wzc tnx cdk fmd
uts: hic yko
aso: vyz psx tvp kqs ufn
ehy: gbc znl mer fmd bkh
lhy: fcn
jrv: qhy gbc qhv let svx mrg auy lns
kzo: rxg
yxy: owi vbe jnc ads
rmx: cdi bxp xxw jbn
kqj: fhg jva bsd wer kov
fju: tso ppt kec eto ghk
bfv: bzc weg jqo nwj
xnt: uvg srg kqn scg lcj bgm
ckx: xir fxy pkh vdt nri roh
mwl: oow iwx etp fyc pux rxp
wfa: ber fcn ogg hll vvr ogc
lfb: hue ygk tgd qfu xoc etz pgf ipc sms
bcu: mjx ssc ils wxx
ocb: yth kyu vem
zmi: jlc cgf wer qfv loz
wrc: rui wco
pnx: uct uqk ojc iss hls yew gjr
ach: wyx jbm ljb nsx ipj
efs: oiw oco mxi mlt vgl rza rdu
qhv: cgt puo
pls: uhm jqp
rti: nrl cpn
xoi: srv ipa eaw dgz nxm
ggt: qqx pqb fyw bkw
ahr: tda vem vce com fzh zvu
dky: tsz wmq ckr
div: xmh huv wkk
uah: vgg gfl
slh: jqo uyx ils
wea: ont wqd csx
wqg: igo dky gfw jtr rui niy mov
kmx: vuy uxp ieb ehe wjd yfv jyk hox
muv: usg jxz kdt fwp
fax: wdq zjs mcc vxk cdi alu gwh
ynh: jbn eri tda
nwp: upi iqg pza zod zbt mlg
van: yai wlp kjw
bat: eub hpn ezd agq jqx jfr
qur: rvh oco zpi byz hbx xpd pfs
jqu: ohw awg
fnk: lix lbl mcc
vcc: ifj aht
zrg: csz
qpq: gff nme enk
whb: iat pzj mrg thi
tcp: kxw jgc smq pth qtq
klh: xkt omo omb qoa
vya: qxj udq xwq eqs jzm
sot: jyt exz
kyu: nfv ocb
gil: hob yvm hyk ozf iip vfb fwo
zfj: tnx quv xfi tjg
nmb: rpo
gyq: mri rti ylx qws
hlc: ima qef lrm
qmc: fwo lrm cgb
zhj: njr
olz: vpd wtf ijv itp hrs
hoa: pte ybn
rqt: xru yew mli bsj sfh tze uos aam nlp jvj
fis: zjw hmk ils
ars: okp
vnp: gqb jqu
vcb: xud cil
tap: yss wkv pte wzy nck fya vww
gfj: pxz gqg boi ajx jkx gui
bxx: rug wll eju bfh owz idj
zyy: fwp wbw
bzi: rsj fey tiv jgc rvh hxx ieb psx jty mri
sbm: pxr
zqg: key leh mrf
eri: cew npb nxm
cyz: ppw log
xdr: zag
com: kss ahr sgl
spg: vwv
mgv: ntm cln vth xhb aow
pkv: qlx gui uik eoy zvu
sca: ewx dfv yqy
atl: fre nfv tgk dam fio
skn: hbx wsw ifi grz dgv neh rxp lrm
gsv: vtw rhw aqu kdt tjg pqm nrt qlj
hab: kxr
ijv: olz aak bjg pzu uty
lwz: vmn dnv bfh yxr wup
ztd: svx oxi gyc wco
rpv: zbb ixb kol zqn hqc
omb: klh lvw tgd nvi gsw wxx bhq
cbp: nip log oju xoy nra pxf usg
hbx: cli hrs jty plh
hkf: pth
ses: wwk
ojj: fax ukn pxz sqs gyf wea igc erh
elh: jfi oak egb nqb
jmk: nuv rem qfo cyo ysk
hla: dog tbl svu kyf hoa tsh zjw
jlu: qdr pmc eaw
muf: rfm lvc egh kwv nck
fdt: zay vqh pip
aey: tzu vjt kdt
axk: qvi yrh xds mnl
mkv: lqp sfh zqn jkt
pyg: jlk pol iyk dch nmh ywe ixb
pza: nwp zvx znl ehe zkz fcn
uxi: sly cgf irs vnd gzt ijv euc
jmc: uge htx ces evs qwc
pfz: jlc vgi mfc qam sml etg vbp
zpn: gcn apj
uvb: lbb hls fre zje kvs wmy
pzj: opl zar
lcj: spg ipc mnx xnt
neh: pzu vdm udg fyc dyz ypw cmu
bra: fiw
yax: lai yti vce zbb qmf iyg gdy
sqs: jlk yfa
ukx: vjn cri obc
qri: clv wbc bgq ter yys nxk
lhe: hox wqg uty vsy ogc uam nrt
qgb: yzj jjr
cmu: pvb dpr
qef: ygs jie ybf
bvg: jyk zpi qqh tfa
fzu: heg rdj sdi bou
uaz: rjy ljy zzx byz
jxe: hlm eub ozf hkf
gui: otg eqc gfj
tvp: fmz aso ion
tmh: jcw qqh
xvb: mkz
cls: lrm eub apq rjy fmd
xkt: lck ywe syf miz klh kjw xum
smq: jie ymp lwy jxk tcp cgn jty
csq: mrt rai xwu xgx cbg
bfq: svu luu ciz
tjr: ouz vqh
iud: wlt frh kta eri
had: hey nmb atl rgh mwb kwv
jqe: eae qtw giw mnl tkx
ryj: gcf qax izp
dac: pwn ebk csz lns hkf dii xje mei
abg: icy wdq lwz
hfk: ont jkx rug srv jpo aam cdp
nld: idj hor nok uvg
ces: fzk phq uct
pvk: cuq uyx yib
mer: zjx
rko: khq ybf oiw udy zyh
woc: nop izd nrs
lai: mqk ugl
ywf: pgr gmg awd
rvj: oim aey
oak: elh nld sbm
dot: uuv rpv iqz dfb syf nqb dmm
nok: cln zhh nld
pzu: ijv kxr quv neh
xds: tyj ohw fmz
ooy: wrx nri jfi tjr dnu gkp pkt fiw
lbm: ayc cdp nlm ugl bsj hbe
kjw: xkt pkh fzr wdq mwb qsv uhm van qax mny
pol: lxj egb
hzh: djw eio yez
isw: dnv ugl roh
qhk: tkj lvv
jkt: mkv
kqn: uhr ysd ufr nxk jtg bgu tzm svu xnt
oiw: nza efs
ict: vth uhr ciz wkv
opq: jcr vdt
koi: bls dnv uuv hbe
tnu: sop yqr ojs jtp
hun: eps wnx dde hmx dvm
pyl: cms eub vzo mov ewx qeo psx
hep: tvu vth lvw dzq
ozf: gil twh
cec: bjb wnp hnn
doh: rjq vkv fpw qyh rql cvz
ixz: iwx qmj mer
nfg: gug mef fpw nme
tfc: xfr dzb tgn heg tis fwk hml
vqh: ixb tjr hls
dbg: ous qtw qfv tmh rem mro
yqy: nuv sca yxz
hlm: cou vuy
jyk: cpn fjc yez hll pkq kmx bvg gzf iyi lns
egb: pol miz tkr elh dhf
hig: lrm xxx oiw vvu hnn
bwz: afx jso thi
wko: cur igz fmn skt sml ogg
ccr: bzw pgq jhg pzj bmp mfv jty
wjj: zvf vum dyp ael
ccb: qvc nkr
cli: ccb hbx fqf pxu juu dda
baa: zjs
jzx: ous jbm esf dag ufn
jcr: opq wkk kvl jzm xhb vqh cfa uvg
odk: cuq npb zay
wbw: vcl yez
kex: ysk gzy qnr ocj ucn ppw
boi: gfj bgm rpo aja
gqg: gfj kdb
exh: wwl dyz ljy xpd ccr obs
hyk: gkr gah yqw nza adk wdv
qaz: kyf qod tag vpc nfg ano
fmz: xds riz ymp tvp xdv
zrz: cga xvb ove zmv dfm jaw
pjy: vxt wrx ghk vqd had nsu uik lrb jid vos qdr
ndz: whz qwf xdh wpz rgh idj
fzr: bfh jjm eaw fzk ngv
ion: hjn djw inr svx tvp rvh
aqu: gsv jtp itp mhs rns
cwt: bfx txe zjx tzr dvm dop
ads: eri qwf wkk
qwf: vwv ivu
ahq: wlt wlp lvc
wpn: ggv hpn wyx ylx
qcq: zjg pwc
nme: xir ars nfg qpq nrs iqz
lmn: dim nby
vdm: mda ork neh mer ewk
xwq: rgh pip ugt aow vya jzm
pud: phw jid jtg
lcg: bjw dim iuf vbe
dde: mjd ggv fhg
aam: rqt hfk erh xqg xxw
bfx: gah cwt pct oua cgf
qhb: yjy omo nwj
xdv: odt iip drm wjj
dqi: irs nrm
yti: eqs nrc yax
aak: vzx hvq xpf wbd dfv eof
lws: wsw euc gyc
vum: wjj zkz
hqc: whs ouz qoa opx rpv
njf: grh jid svu gfy rgh ivu
hkn: nwc bpe vkv zqn hgz soe ayh
gwz: xgx odh soe
tda: pei ent
nwz: nwc yai ukx tbl cyd uos
jbc: bgm frf pkt rau sbk qwv vgg lic wbe
ljb: nbb pfs gmg vbp kvx ach ufn
qhy: jrv mnt ahh cns lah xje
hsh: ygk zdg mjj uui wpz egh
qnp: vvh tap keg mph hor ojj fml odk mtw
zje: uvb foc enk
rlh: frf tfn gqg iyg
dog: hla gvl imx vpc eri dkj oug wdb
pse: apx yss
nmh: tis jbn pyg klh kel
yss: tap kwj ngv pte pse
zkz: vum sml jgj qvc
hcc: bek uqk
noa: loc qmf lre wqq nwt
jtr: uad wqg jbm
ypw: qjr
psx: phy xpf
gjk: yjx kbw dnh odh yhl bdw ueq ywt
etz: igp lfb nmb yza
cim: xiw gug cus iqz
pcw: hqg gfw jnh gkr
zyh: pxu jbm npw pkw tiv fye otu rko qmk xrv mtp
tmi: mxi zrv ioi ous ggt npw hjn bmp ysk giw pqb
jlc: pfz otu zmi
kxe: ryv ldq wrh
hgz: hkn
ywe: xkt cvz oma pyg
eih: cew ojt mwb bpo
kvx: ezd iyi icn dqu ljb ytd tmh
gjr: nvi wcp wea bjw pnx jlu dnu
rgx: pnm ljc sop mys sws
zvg: tka vvu jhg
nhf: dgz lvc hml
mlt: efs bzp
bkh: ehy qmk wco
loz: rui zke kqs tfy uez kdt dxk zmi wmq
hrs: hbx olz dfv
pbb: gjh lvv gtl
hjy: cva kol yss omo
zxr: uez vbp nim qmc tub iip cyz vyz vuy gjo
djb: hfz rkt rwc udy yzj gjh
mfc: hob tgl pnm cgt
nuv: qdt pkw gzt mei eae yqy niy jmk jxs bjg
zph: lce
xyj: ybd jnc nba wdb xdh sln fgp mgv kdb
rfm: mwb bfh rjb owi
zpz: wdv rhw ejv tjg phy jgj tdu
kyf: jnc hla
pyh: ses jkw ion
qwc: hey baa
uez: fyc tmh
etg: law ktp kfn oju
ehe: kmx mqo xrv
zup: lxn oug zbb wdq pwc syf
fby: nfw fnk rpw zay pkt
zce: mir jbm mro sly
ewk: gzf fye
xez: oql
euc: pih sws jtr krm lws
mlf: bvm bxp cdp eod ocb
vgl: xoy cou duc
fdg: faz yjx dwj csj
asw: ipc xcn pmc
hds: gwl zux tuw qfz tja izd bvr
drm: qnx ubv
fzk: bih prf
vkp: jfz nqb hcy ztr ynh
sms: mnw fbs lfb
yfa: dnh sqs ipc jrd yza
tkx: cho iyi jqe
krn: omo gkp
sop: pvb bnr bjb dky pcm nsx fel pcw
val: tpr ove nkt emq fzh ocb ttl eoy
yqm: ybe fim seh
mnt: oyt vum qhy lvv xpf
lnm: bae byz dqi mqo too wrh
ulq: pzu ybv pvf dop gph ipv
puo: leh kkp qxq
erz: wrx sln krj
kfy: jaw cri
mri: bzi
tbl: nwz slh ord
pir: mnw wfd gff kcw gvl wdb
dnu: vsf gjr dft miz llg yig
icn: uyi wwk dkd
tgy: ous hjn pvq let eza byw odu
uty: lhe hrs
uux: rsj mnl gtl xgz qtq zck
vce: mmu sbm zrz gff yax
thi: bja
tgl: sly dda uto ggt uxb
kaf: uty kxe mhs bdx fqg pux
kze: nvi bfv ipa omw pmc
csz: wsw bwz xnh jxs cbn dvm zrg
sxw: hor hxq nmb qsv mxb bls
gym: cva cyd llk
heg: ukg bcu tfc fzu iss hax eih iag
kxr: vcb bsd cox afx ics ldq hab jfr pzu cls
cur: tzc dkt ipd
awg: etp jqu
tze: rug zxs ocr vce dcx luh dsq rqt
vvr: lah vlo zyy cuo wfa wma
rgh: ndz mef cgy pvk njf xwq
rpw: lee fby odp aja reg kta iit
ryv: zod
nfo: boq
syf: dot bpo
tzv: xan ipj eft wdv bef rhw hkf
jtp: njr aqu hrs pdr fmd
wqd: ybp van wea lck
xum: xkt kss
zcv: oaz owq roh pwc fis
fyj: koa vmn mrt izn nxk cgy fby
lrm: zag uzq gph hlc qmc cls lhz
ubv: eae pfh lah
zqi: iuq owq rpw van ayx vxk
xpf: syb aak
txh: dkb ybv wwk zsn beh vee
dzb: jjm heq lbl ssc kec
cdk: uam xgz mkm tkx lzf
lhz: ber hvr vcl
ugl: ybn ghk lai xxk lbm isw
ige: kcw yjy rqv edc eqc llg yhl bnn
jyt: kcm lee rpv sot
cce: hpj jxk vrd vfo
jso: fmn vvk hzi bnr wpc bwz
nkt: rdj lee
ume: mlg gqb vax dxk dbg zsn cmu
joy: sgl igc
lvc: nhf ahq ord
mnw: vww dvi pir sms omb tgk jxo apx hxq dsq
rem: rvh jmk lnm ago ses
gas: bdx gje qgo iip mnl auy pcm
esf: kca oeh ber ugz quv
frf: llg jbc eod lqr
uwb: zlf lpn gyq gzy
bef: qgo jva dax tzv ldq imf
foc: fbs lpl qnu
rjq: iqz ocr yxr krn
ahh: bkz ihc xwp
ycd: ryx cln otg bwg kwj
ppc: jgc odt iph udg
zod: kot hof fqf nwp ryv
ktt: kxw oow
zqe: bmp xml sys
vcl: qnx lhz txe wbw
zag: wpn lrm dny zsw zyy eft xdr dwz qqj
cdi: hcy fdt rmx hms scg nfo gsw otg fax pip hqc now
nxm: xoi rxg ihd ybd
law: ngu etg qtw etp pny wwv wsw wnx
zio: too jmk vlo ses scm vgi axk uzq fey lnm
loc: equ noa
gmg: ljb zzx
emq: nsu pqj bhq nck zjg mii van sgl
huv: tzm dim lrb div oak odh evp
oxi: gzt ucn
ojs: okz eof
dda: kqs zjo xfi ggv ixz dpr
zuz: yqw csz bsd dlh rwc nem lcz igo gmj
eza: tgy bxj tfy
phq: pte ces vbh
iph: qhy mjd
gah: bfx njn dyt qxg mlg
jnc: uny yxy kyf ahq uol
fel: sop awd qvi hbx
ofa: svt qph grh cim jaw rxg hbi zph
vyz: vhe aso qsc mxi
psn: bou zfc npb bew qps nld clv
scg: lic xor qax qsv xnt
ybn: kvc ugl hoa pip abg mrt
pih: uuo euc
uuo: syt zkz fmd ngu adk ezd cyz jie pih mkm
vdt: phw opq wkk ugt dsq
oma: zux tda ywe alu kjy bew cgy
ttg: oow hsy wtl jhg fds
hob: gil bqs nqv jfr ipd okz zim skx mfc
nby: lmn
fya: tap idj krj ywe
sws: cil
bfh: fzr rfm
cvz: ywe mnx xru itq
edz: nop llc egh mli qoa
pgr: yzj pzb qsc ywf zbt
zdv: zdf oul reg ehg
rkt: zjx qef djb wbf cwj lzf
phy: gkr zpz xug psx aht log apq
qtq: ahm gje
qgo: uad khq gas bef
vji: gsw hom rau ueq uxc
izd: icy nop woc hds
hjb: uhm gop
lic: scg ryj jbc zdv xru dfo qph
llg: hcy pie ige frf
zvu: zfc dsq hcy ahr
jaw: yog vem kfy
zke: ucn hlc xib lpn tea
izp: asc imx zhm ryj
beh: vsy grz xkp
xtc: iit sln
pxz: cyd heg gfj ayh xez
duc: aup ipd mhs kef kjl
cwj: oxm aqu shb npw
xxk: yti vww dnv xvb
qqh: hox tmh
xjw: qhc cmt
fla: vxt dkj lai xwu
nop: slh dfb owq izd ilm woc lre
cqx: xrv uto
hzi: qsc dag skt jsa lvi
zdg: hsh ayh gkp
bek: zqn uge hcc
rje: too tzu
znl: qnx pza drm
qfu: cdp mth zhh dzq
uct: ikg pnx
wdb: hue lgu ubq
auy: gdw
pxr: sbm svt kcw csj
iia: pzu qhc tsz nnx
nvj: sfw rka
tgk: ysd jtc
dfv: hrs giw
dpx: kfn jmk kae sdk ylx xod
tja: hds hor vzc ztr lde nrc ptf dnu sfh
kdt: loz aey oxm twh gsv
ktp: yrh lvv dax yzt uad
iqg: lsf ahh xml rem
ylx: gyq wpn
jjm: dzb
aup: eio duc hll
sdb: cri wxx vww bpe
kca: rza djb hlc dkd esf
zxs: yjy tze
eae: shb mtp ubv nuv lwy
kxi: okz zrv jfh hpj xxa xml
ppw: vjt yqy kex
zbt: tkj mda pgr too hof
qlj: xqa kja mrf gsv tzu
wtl: ttg bwh pdn
ysd: drq kqn
gyc: lws ztd inf gjh ous
drq: eju ukg ysd bra
mqk: dkj ont lgu lai dcx
mei: dac qef
eke: qwv nrc jnp yti pef nwc oak
fqg: kaf
ezd: ybv kvx
nlm: wbc lbm qhb vsn
koa: fyj cgy imz lzn qhb zay
wzy: ywt ufr
xdh: ndz hic gqg gwh mph yko div
vea: dii nct
gnz: kot hjn tzu hlm rje
qeo: vrd tzc nnx gvo zrv grz gjh
kcm: uyx
tfv: mtp wsw itp lah bmp pzu
zsn: mzh
kov: vfb
jmy: ogg mnl
bnn: xmh oul mon ces ige tpr mdh
rls: iag noo apu ojc bvm
yys: uui boq qri
uxb: xxa tgl dlh pdn gjh
tot: hyc mgd yqr wwv hsy
wup: wvb lwz wlp
kke: vxt gyf qyh oql gwl qsv rau
nvi: kze bdw gjr pik tjr
nmq: svu qwv whz ilm
upi: mgd nwp yxz
pfh: axk hll qws bwz xgz ubv
wkk: div
xud: ceg ybx oua xnh dyz vcb
bjw: lcg zua
qqj: ieb tsz cjx zag zfj
ove: llk zrz val
pnm: mda ael dqi oxn hxx ugz vyn tmh uaz jfr
cou: ipj hlm cgn oco
cos: asc zjw opx uvb thh bdj yno dgz eoy pie srg
roh: syl ckx ils ciz tag isw ssy
igc: ojj yth joy erz jfi ovw rxg
gwh: syl phw yjx kss edc ybd iag ojt
mqo: gtl
onv: thh jzm ocr jqo uts bjw
ied: hmk lck jrd qlh dwj opk
dqu: kvx muz wco cyo
vvu: wjd qgb vlo tub zvg
fyw: ggt dny pbb dii pxu cox
mrg: vbp ahm
lbl: exz wup
qvi: acg nqv nbb axk
bmp: tfv zqe rvs
xug: kva okz cho tnx wdi eom
ayc: lbm yew fnv ywt vkv kyu asc mtw
twr: qcq luh
tea: hlm pzb hab txe gln cgn
otu: jlc bkw eof tzr
imf: iyi
kvc: eqs cln ptf ybn yxy gwl
gln: tea cjx mjd qvc
wbe: khk sln ige hls xhb gjk mtw yno
gmj: rvs tub yqy
heq: vya vwv hgz xmh dzb rql zwq jqo yor ptf
pvp: yxr rnj owv kyt llk dog whs rxg iyg
tfn: ipa
iag: bnn mhw apu sbk rls
bae: qmj zvx djw jgj kja lnm fel ouo
mjx: fcf knh ywt bcu
ivu: qwf udq txd owz njf bxx
tnx: lzf zfj xug wbw jdr
dny: zag wdi qws fyw zha fmn txe vpd
mmu: lck vce bjw fzu opk
mkm: hvr zzx
ntm: knq mgv
imx: dog izp jnp olt hcc
idj: ndz ugt jvj ayx nld odk bxx svu hxq jmc fya yxr
qoa: edz uqk egv lpl klh bdj hqc bgm umx oin dog
wer: pvf
kkp: grz oco puo
olt: imx cva swm whz
ent: okp loc frf tda syz
hmk: nck
kbw: bls crq iuf ocb fnk jqp xqg
qwv: eke nld qph tgk
pzb: wwv tea
iyk: pyg pgf yko umx
ilm: frh zqn
kdd: ukn zwq now nok
let: fmd zrg pgq tfz bzw jrv
otg: gui mon ztr bmm
hjh: tfa rza cil cgn skx
lvi: qdt kek vqv sys
avh: kto oju afx ysk obs
ojt: hms owv
ciz: bfq asw
ayi: ebk xud zxm hlc sun shb eps
now: cew pol kss
ktx: nwj ils uik
xje: qhy qnr
rqv: kta iyg izn yhl
dvm: jie hun opl zsn csz tiv
oow: mwl ttg
ptf: heq kvc rug vci
pkt: opk
wvb: foc alu ybd kec wup prf
yla: axw zup drq fml vem gdy
aja: sgl hgi bvr
gzy: dgi ljy nsx
tub: gmj wzc bzp
vlo: zio vvu vvr cbn obs
pvb: xml cmu cms wrh ypw dkd
wdq: kjw sbk qyh pte zup
tzm: dnv hms kqn bcu huv mth
mph: xiy
tiv: bzi dvm zyh sdk lwy giw jnh uee
svt: weg
tqj: gcn xqg
hcl: wmy gfl khk
kvl: nby owv fis lvw fiw tgd
ngv: yss jtg iit
cuo: oyt yzj vvr jdr
mtx: huv hgi etz tze ttl zpt fdg sbk
yxr: idj pvp lwz
pfs: fhg qur
yud: hxq nvi eyb lgu xez xwu dcm uon
fwp: rcd muv zyy khq twh rti
hpj: wnp zqe jxe vhe cce qqx
gph: tfa jty
izn: fyj tgn
uon: yud spg miz
oju: imf cbp pgq rfm
tcg: rdj sms boq
equ: wmy loc mkz ihd mhw jfz
cva: hjy mjx olt lol ueq gym
nza: wma ixq oiw tzv ryv hyk
tis: mxb
gek: hom ehg
obc: boq qdq rai mqk uui ukx
xmz: dts vbe ijm vos
bdj: jzm pls nvj iyk ybp
ano: qaz oaz lgu
ugt: uba idj
qhc: jfh jsa mgd xjw zfj dqu
hic: xdh csx uts vos lbj xor edz
ycu: tnj rvj uzq wpc
gxc: eyb
jnp: pie tsh xnk
nsu: wqq xmz
rhp: sqy adk nsx tfz ocx ehe
xqa: lhy cmt qvc zlf qmj qlj qmc yrh
kdc: enk
nyx: yno cus ttf dmm rmx
bsd: zuz fig kqj obs
tmr: qnu vct fgp bek bdw ydd dam
bqs: cgn jcw unf hob vvk gnz
xib: mhs qvk zke
zzx: mir yxz lhy gmg aht
kox: yns gug xqg
fio: nrc vct yys nrs ihd
mda: eio ojp kuo vdm pkq oxm znl
gff: uge qpq odp vce
lxn: htx gff wkk pnx csj yys nwt rdy odp zup
cus: pcu sms mny sot
fig: vfo kfn hvr dag
bnr: sop bxj
hbe: yns koi ryx
yko: ywt zux iyk
pkb: lqr jkx otg yig yjx
oeh: xxx exb sca
wmi: dxk cqc hms vnf
ffa: rgj yor qyh
qqx: zrv wjd odu ggt
hxq: yud
kel: pqj sqs nmh evp kcw sbk
nkz: rlh nqt lck jlk kfe kss pmc
ous: jzx gyc zyp qhk
ogg: gjo jmy wko qam
vvk: riz jso ryv bqs
wdv: zpz ewx eqw ipv
whz: qps bwg zmv iss olt ndz
obs: exh dgv vlo djw
eft: tzv lsf tzc gzy hyc
eod: npb
rka: nvj jfi bou bfh sgi
hey: krn bxp had qwc yhl xiy eyb ttf
cox: kxr xib mlt fey fyw cqc inr
ryx: udq ont
eub: xfi
jqo: uol slh
reg: jbn tfn qmf jnp gwz
uyx: kyt slh qax nfo iud kcm etz zje pvk
ufn: aso jqu jzx xwp
rbj: jkt clv nhf ssy tag ycd
lrb: kyf aam iuf fyj ilm pjy
fye: nim dpr mhs ewk dkb ccv
dts: odp htx oin imz wfd xmz uik
kwv: gkp utj hbi
izt: luu okp pik eri wxx
apu: gxc nqb thh iag edc
jzq: wwl yzt xer kvg bef dde zpi
dii: mro ccv ihc dac zyy fyw vea
zwp: ihd qod yai hjb tgd jfz gyf llg
alu: fax mii pmc
yig: dnu vci ovw nxb oak pkb
eqs: ffr yti nlm
rsj: bzi uux okn ixq
cdp: pie qfu ygk bdw vsn gxc faz ukn
rnj: boq vpc pvp rql hgi xxw ayx wvt
kdb: opk xyj fzh
pie: cdp ciz fzh dft jnp
phw: dnh pud ipc tkr bfh
xgx: gwz llc bsj keg fju lre
pkw: vtw fyc zyh zsw
uhc: xgx ddo nme kec ssy fzh
acg: lns nct mys qvk qvi vcl kef
kfu: uba dvi opq ads qvb olt
jxk: smq gzt cce cmt
udq: vmn ryx omw
cil: ors sws vcb
vqv: ygs lvi jie oxi zqe
ayh: pxz enk zdg
npw: tmi zyh awg
gfw: gkr gnz pxu puo vnp
exb: fyc tfz
key: fqg seh qjr qmj zqg vyn mjd
frh: iud ntm mxb weg ilm
srv: xoi qdq ffa hoa wkv jtg nck
lbb: jpo uvb gcn ugt
bgm: jbc vct boi ajx gfl
jxs: csz fim rvs nuv vlo
nrs: fio cuq nme woc luu
tag: prf roh
zhm: asw iit cfa izp
njn: gph mro hun gah xjw vfb
vci: apj sfw yib
muz: hof
iyg: pvp yax
ccv: dii eba vyn
fqf: jmy hxx ics zod lhy
tjo: jfr kek zmi mtp zvx vnp zfj vee
udy: jxz bxk cfc oim rko kjl
oaz: gms khs bsj ano zcv
wtf: olz
tno: ioi beh ifj nkr svx
ihc: ima rti jxz ahh
umc: vlo unf ygs
lsf: vzx tdu
xkp: hsy jqx
sml: ysk ybf bkw dag wko zkz
iwx: ixz hvq uqt sun tno gqb
yib: imx fbd pvk vci
fbs: pei sms pls ipa foc
wbf: arj rkt map cls pux pcm
dch: gyf uny pyg ffa vpc
qtw: zpi jqe dbg pxf cbn qhv jjr
opx: bra izd
pik: jkt ars uah xmz
jva: kqj jrv lvi rvj mlt bef
eba: twh ccv qqx aso skt ppw dpn uux
ovw: kta yig
mkz: ocr xvb tuw lce fla
nts: bcu kdd klh grh vzc bfv ipa
icp: uuv krn reg dfm qax bvr
jdr: map nrm yqm tnx cuo pvq pfs qjr xdr
yhl: ige gjk
rdy: bvr dmm
bwg: ycd whz wxc zdg oul tkr rdy
uny: dch yog xiy boi ssc jnc eod
bjg: pfh mtp cec nuv vnp map
gcf: ryj fgp
oin: vct xir rdj hmk dts
lns: cbn plh acg yfv
ont: mqk ryx hfk
mfv: lvi
mro: zce eub
ttf: egh qhb gmr rgj hey fml
cgn: pxf eof
ils: slh
dft: pwc sln bek eju pie dnu
oul: woc kta zdv qod bnn
tzc: jqx tka cyo
fhg: gfc yqy dde kqj pfs rui
kjy: nby zfc
clv: qri fgp rbj
awd: eio ywf
ttl: asc mjx val jqp
uol: wxc wbc sfw
cpn: dgi rti ewk pxf ezd jyk gzf inf pza xdr zrv
pux: ojp mwl
jcw: nyv cli tmh xjw uxb yxz hig
weg: dwj svt asc
rui: loz fhg
lfd: ijm izn bih vwv cgy rjq
kef: mgd awd duc
uik: dts pkv pjy
vvh: lbl ehg fwk owz mii lce qnp
rdu: ude ehy zyp efs oow khq ufn iwx
bdx: gas hgx psx kaf
uxc: nls mli evs vji oul nmq mnx
xfi: dda eub zfj qxg hvr
wmy: ooy pip wfd equ hcl uvb syf
gnl: wmi pcv ckr
ocr: vbh tze lwz wbc mkz
apj: rxg zpn vpc vci ayx
jbm: ach
owz: lol bxx yai nok
hax: fre vxt qfu rai heg
vos: hic ajx xcn xmz pwc
rpd: hyc krm pqr vtw qvk thi vyz
ebk: ifi wsj
uvg: nld qmf mmu idj jkt zpt csq eaw jcr cln xnt sze
ocj: dag tsz kex
jty: ccr smq hbx
egv: nwt wxc ads lwa
uge: jmc nba gff svt qwc bek
rug: hjy hfk bxx ybp cri ptf lrb tze mii qfz
qph: ukg xmz ofa fzr vfl qwv
jnh: pcw fmn wco cyo
ixb: pyg imx rpv lqr txd vqh
wdi: bjb
syz: ent
eaw: jlu ytm
gsf: ybx pux hkf agq svx cgb seh
ljc: gzf njn qxq for
mgd: kef qhc igz
hvr: fig xfi lhz wmq udy qsc
oql: ojc xez kke hls
pgf: lfb vxk zew
ybe: zxm scm cgb yzt gil njn key kja sdk yqm
knq: dfm ntm kdc whs
grh: nts
nim: zxr
gtl: oxi pbb smq iez mlt wer hgx uux mqo
djn: tda ysd jfi wcp khs
zuv: aox pgq wrc
nqt: nkz fre tvl wxx csu kfy
ldq: awg wdi kxe kxr lch
nlp: kzo srg
nnx: fjc agq qeo oiw iia
uhr: tvl yys fdy dzq ktx
zrv: qqx oxn qeo
hsy: yrh zyp xkp zar
dnh: phw bxp zwp syl ckx xum yfa wqd
vjn: vth yjy owq ukx gff kjy zua kta
wwl: fim exh jzq khq ude mkm hgx
ckr: ytd dky
pcu: ied lmn xoc uyx twr ayx cus lce
scm: kjl ago cfc ptp gfc grz
tvl: vkv llk
fml: ttf lcj
ceg: uez ndm xud cce udg bkh
dgv: oua ytd skn obs iia vnd cwj
tzu: gnz rje
mhw: nkt mli iag omw xvb
gug: nfg xiw hep
bmm: koi ygk mqk ryj qxj otg fnv knh
yno: uuv
bzp: mlt rjy tub
mef: oql mwb nfg sze iag lxj rgh dzq
fre: eoy
cgt: mfc qhv opl cgb vea tdu
jfi: zwq ooy bam elh
wwk: ses mhs
ipj: zhj ejv adk rkt ppc cou ifi ach tzv
jgc: pdr hab mqp bzi zvg jfh kiq hzi tmh tjg tfz tcp ppc
csj: wlp
tfa: bvg loi dfv xoy uez rvs nem gph hmx
vqd: hic eod edc xxk
luh: pwc
cga: ojt bew tso zrz
ukn: tgn kec
bsj: nck kdc lbm odh oaz rqt
ork: skx
syb: xpf jnh exb loi dax
sdi: bls xmh kta omw jlu
ppt: eto koi ads gmr hpr
cms: ics lob pyl tsz yzx uxp ieb xfu ozf ccb
yrh: odu gmg xqa hsy ktp
noe: xnh hpn gjh ioi uux lwy cfc nyv
lol: kwv asw nfo alu lgu nwc owz
wnx: law
wrx: igp gek ckx kol ooy zhh erz
kek: uxb qvc lch lvi bmp gtl
vnf: gvo tfz wmi kja
tzr: byw vvr dkd kuo ixq otu
ahm: dgi mrg eqw qtq mov
eqw: vyn
dcm: hpr prf bou ssy csu
oim: xje rns zjo qgo rvj udy
sys: hly
inr: ion wtl ifj ejv qjr
fmd: uuo ehy
vxi: ouo fyc hyc
ueq: vpc egh exz vji tqj
gop: gvl xiw
whs: zua hqc okp
gqb: qhk iwx vnp mys jsi
dsq: qdr tze zvu vdt kvl mnw
nip: aht ypw
dwj: fcf sdb fdg ngv weg tjr
ygs: ioi npw wrh umc qef
hll: aup fwk jyk wfa
jid: zbb pud pjy
yor: ffa fgp owi lbj iss elh qsv
xxx: oeh vnp nrm aso cil cbp hig
gcn: tsh cyd bpe ptf zpn lbb tqj dhf swm
gvo: qxg qbb vnf qeo zyp ogg okn
bpo: lzn
lqp: wpz utj nmb mkv rtd bxp
tpr: val lxj zux bzc lvw
vmn: lwz muf udq mjj kdc fyj pir
dxk: wmi ume rpd odv ppc ipd bja
vzc: zhh vxk ijm akg
okz: xug cgn ojs
rns: oim aqu vgq
mii: vvh fbd
mir: skt hzi eps zzx zce
zhh: vzc qfu axw ybp nok olt
yxz: jcw zzx yqy log
wcp: gjr fla isw owq sci
plh: fjc mys
ipc: phw asw lzn lcj
fiw: kvl sfh bra ooy kss
xod: mqp pzb dpx
iux: rau rdj uon xru
ibd: hig ahm eio rpd svx fmn
miz: egb dnu uon zux qsv
jjr: bzw ybv upi xpf qgb quv
pct: bfx cqc arj zqg grz ccb wtf
kwj: ycd yss
zjw: cos fis hla jpo wll yog
odh: bsj huv eto
wmq: oxm
vhe: yzj tka pvf fmz hpj lpn vyz giw yqr uqt uyi
xnh: jhg xfu ytd noe csz icn xud
ejv: inr hbx zpz ipj cyo igo
keg: nxb xgx qnp kvl mtw gwz
xiw: gop mon jkx xnk
fbd: yib mii mcc
nrc: qvb xbq yti
iqz: cim
jsi: sly gqb
xpd: pxu eof ugz uxp
ljy: exh rje agq
ytd: fey dgv ckr nak
hcy: umx vkp vxt
opl: vgq vcc pzj qgb
cuq: ilm nrs wlt csu dnv odk vqd pvk tis
nro: hjn vpd
cln: uvg isw ycd mgv nok kvc
ojp: age pux
vxk: vzc pgf fxy
aht: phy pny gjo nip ago vcc eza zzx fds niy eom rcd
zha: dny rcd qvk vzo
fgp: tmr gcf
ayx: ojt qlh
dzq: uhr hep qfu kdc
kss: xum fiw com now nkz jvj
dpr: qgo fye cmu zkz jso dda wtl
xxw: jjm nfo aam ars gyf wll
kec: fju ukn twr qwf dzb
pny: aht cgb lhz
pkh: pqj
bls: iuf koi
gdy: yax vwv nwj grh yxy tfn
pkq: dkd qhk jyk iip mhs mda
idn: eey pth ktt ytd
nem: bkw eom
euv: nrm eey
ihd: nxm zwp xmh
ipd: hob cur
gsw: cdi ntm qhb vji abg yns soe omb
umx: gms hmk xcn qlx utj iyk hcy hpr
uam: cdk kkh lwy vxi
hqg: iyd whb awg
giw: vgl dfv gbc
mhs: duc aqu fye wwk xib
oco: kkp mfv cec
pwn: olz ber vfo kov
ndm: ceg mer psx wpc cli ipv phy
pug: iss okp nfw vfl bls utj qps faz mdh
nrm: hrs dqi ork nsx euv zck jdr iez
bdw: nvi tag tmr
yns: gsw hbe utj
vfl: qph hue kwj
odu: tgy
lpl: foc ysd
wnp: mnl hpj jxs cec xfu ybx xan
arj: pct imf gbc pyh wbf ima
wsj: itp zjx ebk eps
eqc: exz mcc ige
kzt: eqw gas fqf ude xoy pbb rjy
gfy: opq bgq lvw nby tcg
shb: cwj eub sca yzx
erh: aam
vnd: iyi mjd uxi
tuw: dmm mkz qwc ovw
cyd: mli izp gym rfm
sze: fcf uyx evs mkv vkv mzd uvg mef
mzh: igz age zsn
hor: zdf tja
qbb: tjg gvo
lpn: zke uwb drm
ouo: gyq cgb yqw
sqy: pqm
bkw: otu ggt ptp mzh
quv: esf zfj jjr qqh
zjg: xwu qcq sgi koi emq yig mon jzm
xir: oin
gvl: sxf
qps: syz ocr pug whz whs
kfe: vth nkz bmm zay
bja: xnd dxk yzj nrt thi rti cyz
xfr: hkn tfc nlp vwv kox nwc sxf zdv lee
rdj: fzu tcg iux gop nkt jyt oin fzr
crq: tqj rpo lix
qnu: kze lcg nvj vgg foc uts tmr cus bhq wvt iux
ieb: cms qqj bxj
ssc: uny
cfc: udy noe
okp: mlf jbc ent tvl svt izt whs ntm ars kyt xum pug njf
ddo: uhc noa gcf yth mjx gdy
zmv: yza mcc
rwc: igm djb zuz loi hun pvq wmi lob
srg: lqr cos
fzh: pie kdb
hzk: bvm dnu csu fis
bxp: kvs pef
iez: vfo nrm
evp: nok
owq: nop wcp
zar: pzj lhy hsy
wxc: nwt fzk foc uol egv
ywt: mjx yko hue knq wzy gjk ayc kzo
fpw: doh egh nfg
wma: nrl gje mys vvr nza
bpe: vji hkn kfy sdb grh izt
ssy: uhc
uqt: nrl zvf
mnl: gas jmy
cbn: lns qtw
qfz: zpn zpt
vfb: vum kov gil njn nnx
pqr: cjx dyz iph iat ozf aij sws uwb
nrl: qam rko uqt rti tcp wma nrt
nls: uxc zdf vvh jxo ybp lbm lxj gms
grz: kkp qeo beh
mwb: kjw mef rfm eih
ioi: tmi zuv juu tsz aij noe ygs tno ehy hxx
gkp: hgz wvt lce kwv zdg krn
axw: kcw yla dvi eto
prf: hml pvk xez yjx fzk dcm tag
wvt: qnu rnj
irs: wwk nrt udg dqi qmc
tsz: oxn dky iia
oua: dgv xud dyt
uqk: lxj rlh uah hcc
ude: rdu qxq ubv ael ywf npw hll qxl
sgi: rka cew erz ssy
bvr: icp rdy
zvf: eio wjj uqt
bou: hgz
xmh: xbq lic ihd kze div bnn csq owz omo sdi csx
leh: vtw njr ehy puo kex
omw: kze clv
fdy: luu vsn jrd vbe jlu uvb
fcn: yqw pza ses lhy
lcz: pwn gqb zuz
wlt: yno cgy owv iud ahq cuq
qlx: wkv enk umx jkx
pvf: vhe ybx tdu fey cur wer odv
jie: smq uuo xds dvm qef vqv
mdh: pug bnn owq
agq: ljy bat fjc
wco: kaf ztd bkh mys jnh dqu wrc iqg
jgj: bae exe vcc iat
jfr: pnm tjo kxr
gmr: vbe ppt nhf qlh ynh tpr
aow: uos xqg dfo mtw
sun: iwx nkr
krj: fya hzk csx erz soe lce
qws: dny
fwo: znu lhz iyd qmc
lxj: uqk tpr cbg ynh pol
sly: jsi gzt
zbb: yax jid rpv zup dfo
ybp: nls bdj
kkh: uam kuo
bam: jfi pqj
rhw: pxf gsv tzv zpz pdn
yvm: vbp log muz gil zuv wrh
jhg: ttg pqb
dkd: pvb pkq
tkj: qdt zbt aso jie qhk zyp
kja: mlg
pdr: jtp pqm wer mgd jbj
mjd: key
iip: pkq xdv gas zvf
owi: ffr yxy ixb wxx rfm
faz: fdg
vbh: sfh eqs ocr kfe ter xor phq
qsv: sxw miz bpo ijm
gzf: nro ewk hnn
znu: kqs fwo vgq jrv bzi kot pkq riz aqu
pqb: tmi ggt jhg dpn
wzc: oiw rsj xer tub let lzf
uhm: baa uui pls hjb kjw
fnv: baa rlh wzy bvm bmm qxj nfv
dag: fig gmj kiq ocj
njr: jtp nqv zhj kkh iat qnr leh nbb
egh: hsh muf ueq
xwp: seh nqv odv ahh ufn igm beh exb
qvc: gvo pqm gnl gln ccb
gbc: nim hlm arj niy
udg: neh ceg wtf
sln: sot akg erz
cri: rug kfy ukx hpr lee hgi kel sdb
apx: bgu gop wvt ygk kdd pse hcl
vuy: kmx
dlh: zsw yez zuz
eyb: ord gxc sqs yud
rgj: ffa dzq opk qlh
tfz: exb let jgc bxk
jbj: jkw wpc xod ohw
gfl: qcq mli khk
pcm: ysk fqd wbf
yfv: sqy lns odu
ber: wfa lhz odt pwn ics esf vdm ezd
lah: tfv wnx ubv qhy mtp
dyz: xud vpd qmk
nba: tgd qdq
vgq: map opl kkp qam znu rns djw
vtw: adk zxm pkw rpd uwb qmk
boq: nfo zew yys
iyd: ogc aey hqg sws qmk eey
ago: rem
sfw: uol bgu vci xtc qmf onv nvj
pxf: cbp qtw rhw cgn ugz dqi
vth: kfe ihd hep gug zqn
dhm: bkz
dwz: mlt pcw wko qxq
bwh: jfh riz upi jxz cho wtl cqx ses iez iip vyn
swm: olt fml vsn fzh noo vya
ysk: kex hof uty avh pcm sml
bih: lwa loc fzk
wsw: uxp csz tfv awd lws skn eey uty law
jrd: qxj vct yfa rpo
cyo: jmk ejv
vee: pdn txh
vzo: zsw jqx
twh: eba wbw fwp ozf kdt
uxp: tka xpd
ipv: wdv ndm ppw
pqj: bam kel eto odp pse lai rai pkh
qxl: zod niq dkd oua
sgl: aja joy emq
qlh: ayx gym
zay: odk fby erh fdt koa
dop: cwt
dgc: jfr wmi udy muv wsw wrc lvv nsx
mqp: hxx apq qqx ouo gzy xod
adk: mov rhp uzq ogg vtw
yqw: hyk kja gbc bkh
sci: vpc vsn zew wcp
zpt: uvg olt qfz llc
rau: jbc vji kke iux mth wns
zua: whs kze qdr onv bjw hax wqd
ghk: itq pjy
jtg: ngv srv
dyp: gzf tnj skx aox uwb wjj yvm pcv ozf
cqc: pct
vsn: sci fdy evp wqq
pth: idn ogc hkf
wpz: hsh nwt ahr jfz ndz gui soe
zqn: bek vth
zjx: mer cwt inr zjo
gms: yth zpn oaz
tgd: lfb kvl
dyt: nip oua dwz kae zxm gyq jtr ifj gah
kxw: tcp gje log ktt
omo: hjy klh krn dfo
tyj: zlf hsy rvs xds
aij: pqr fhg oxn jkw age ioi kxe gmj
yza: yfa etz ntm zay cbg zmv
npb: odk boq eod
tsh: srv xiy jnp gwl uik sqs zxs pkt gcn sci dts
khq: fwp rko hmx qgo
vrd: xan qeo qnx cdk cce pyl
sxf: gvl tcg rpo
kvs: ywe lzn bxp mon pik tgn ztr uvb
wrh: vax yvm
kfn: hfz etg fig bkh
hox: jmy wwv hpn qqh gzt oeh
pip: ybn cdi krn
qmk: dyz igm bkh iyd tzu
ehg: ysd pei gek srg zdv hep uon
vkv: dmm hkn nww tvl
oyt: mnt fjc wmq gnl uee bzw cmt txe cuo kvg
nxk: xoc tbl bew qri
llc: xqg iss xiw spg zpt xor jtc
wpc: ndm jbj jso ycu tzu tdu
lck: nkz xkt
luu: fio fbs fdy izt xtc lce erh cew ffr bfq nrs rgj nww
ikg: wxf dhf yns egv uct
tww: aam csq fcf ydd luh rtd
xru: rqt opx cvz
bhq: ojc txd fgp
svu: zxs hla bfq
jfz: vkp eod zwp kzo woc
exz: hom lbl eqc sot
ytm: apj khk kox wll hjb nby eaw
qxj: jrd eto bmm
qdr: jlu kyu dsq yib knq kvl yjy
zim: ohw ljy ocx vfb mxi ork
jqx: lob igm vzo zxm bzp bmp tzc xkp
ifi: qxq ebk ocj
uyi: tka icn
for: jmy ewx tub eub vcb
nqb: hbi vkp qcq elh
krm: hvq kxw iat ybv euc hgx let juu
jvj: jxo kss mth
hyc: rpd qxg
vwv: xfr lce ikf dmm scg mrt lfd gdy spg qwf heq
nsx: rhp gzy sop nrm
ybv: krm zar
tso: xhb bam xiy
nyv: loi ybf eft riz lws noe
fcf: tww dvi
rvh: rem
zew: boq khk
inf: xdv umc vxi ccb gyc euv
ixq: rsj hmx
skt: mir hzi
uba: kfu rtd ugt yxr kvs mgv faz wqq
bxj: eza
igo: gfc iez gnl wqg ejv ehe
lee: rpw jyt cri mzd nkt gvl tjr alu
mrt: csq dot xgx ybn mth fyj kyt
lbj: noo hic nww jtg yor yth zje tso vxk khs eju
hjn: ion gnz mlt xdr hnn nro dhm
pmc: asw alu
mth: qfu
dvi: iuf axw
qyh: fxy vbe dfm
ucn: oxi kex cil cns xfu zhj
vsf: sms tis dnu
imz: aja olt
uzq: adk iez tvp
pvq: rwc shb
iat: pqr njr lsf whb
xrv: zyh cqx gsf ehe
eio: zvf ago awd aup
log: cbp kxw cyz yxz
noo: rls xor swm wbc nrs lbj
ord: eyb
qam: nrl pfz ogg rvs
zck: nrm xkp uux
xhb: khs lix tso ads jcr mgv hbe
mxi: efs gyc vyz
wwv: hox pzb zrg
byw: ocj vyn tgy xml xib tzr apq
cgf: bfx
tdu: cgt lch cyz lsf
dnv: isw lwz huv zcv xxk koi hbe
hom: gek vji dfb fdg uxc exz vkp pud
gzt: hox zlf sly uxi jxk
hpr: dcm ppt
djw: bae obs
rxg: gfy pvp edc fbd nxm apj ahq igc zph kzo
qfo: wbd auy jsi
uui: dgz yys
edc: rxg
cew: luu uik eih qmf
lgu: ano uct lol
nct: wrc wsj syb vea yzt cgt vxi yqr
usg: gas cqx kva cbp uad ezd wrc kov muv ybf
zvx: bae awd vpd vdm
rvs: rcd bmp tfa jxs gmj
xiy: kss tsh dgz mph fzr tso ukx
sbk: iag mdh kel syl jbc
jsa: jkw bjb qhc hzi qhk
rxp: mwl ach usg xdv tvp rvj
opk: mmu pkt rgj
lwy: noe eae vnp tiv
pdn: rhw wtl nbb vee rns
hpn: noe zck
gwl: kke dam
ogc: wfa lhe xib iyd idn pth
rtd: mjj iux iud kyt rnj lqp ehg
oxm: mda kdt wmq
xwu: zjg syz
dkb: txh uad
knh: vem wns tqj
odv: fds fqg hab dxk xwp gph
wyx: imf vea wpn ach xnd
ajx: gfj
gfc: fhg cgn igo vzo fcn
lde: tja frh iuq ent vkp rqv nlm
dhf: fnk vqh mth hbi gcn
qfv: dbg zmi
yaq: fbd lix bwg kyt
dsv: kiq kae qfv
cmt: rhw jxk etp skh xjw
xoy: tfa itp aak
vct: jrd fio bgm
iss: hmk syz whz rjb wfd
vww: nck
kva: xug dax ljb xxx bnr dgi usg
juu: tka krm
qjr: key lns wwv inr ypw
pwc: qcq luh dft
yew: rjb pse dvi hml
qax: pol ryj scg
ael: yqr mri
fds: ymp ttg
odt: ppc
xcn: fdg vos zew gxc umx asw
ikf: tvu pls div eke
dax: bef dkb zvf
oxn: mei tsz zrv
csu: hzk
age: aij pih ojp jec qgb dii gje lcz mzh ztd vpd
hfz: eub qhv hll skh kfn dhm djb uyi
yjy: imx zxs ufr qhb qdr uxc
ldt: tcp kef yqr pqm mgd hof vxi cce
kot: qhy uyi ptp gnz zod kov ggt zjo
dpn: lvv pqb zpi
tnj: mer
vfo: fig iez
vgg: uah qnu bra ojc
ics: fqf ber
sfh: rqt fiw
txe: wnx zsw
cgy: koa
mli: evp mhw uxc cyd gfl omw evs
bkz: kto pgq dhm ahh dkt
fxy: qyh zwq zew vsf pkh ckx vxk
jkw: qbb jbm oxi jbj jsa
ufr: yjy mzd dfo ouz wzy rjb
jkx: gfj ilm qlx joy xiw pkb
kol: hjy uos rpv wrx zjs
wjd: uam wko pih ieb qqx mri vvu niq
bzw: oyt ccr let
dkj: dfb
pxu: zyh syt gmg xpd gfw dde fyw adk qvi bxj rko
zfc: zvu lwa
wfd: xxk wmy pol
ygk: tkr hbi
cho: tkx bwh kfn ywf yqw
qxq: ude nra puo
dfb: dkj xnk nmh nba nop xbq
ima: arj hlc mov ihc ktt niq
zdf: qfz zdv cim nls hor gcf
cbg: lxj txd yza
fbv: jpo luh jjm frh yaq pip sot
fim: hxx wwl ifj
loi: syb tfa
gjo: exb plh
xgz: pfh uux fqg jfh jqe uam cdk
nwc: xfr kdb hkn nwz
vzx: zrg hob aak xqa lsf kvg
nrt: lhe map vcc
dgz: kyt uui nhf xiy
nfv: kyu iyg ijm
yez: jxk wbw hzh dlh puo
evs: mli gek
ybd: gwh gcf
apq: byw vjt mqp phy
eps: oxm wsj mrf odu hun mir
igz: wko jxz mzh
ngu: law zce cqc auy
qmj: hfz key ixz bmp
zux: hds owv ukn miz yko
iuf: bls dvi lcg
bew: cga oma
ohw: jqu xds jbj dpn bkz
vjt: wmq dqi aey apq xer ppw
okn: sun gvo
ybx: wnp pvf gsf yqy
dfm: mny zrz
jpo: hfk fbv ubq hoa ywt lbb
dim: jkt lmn jid
itq: pkb cvz fpw ghk mzd cva imz
xnd: bja jlc zxm ewk
xbq: cfa nrc
vax: ume mfc wrh lkf hab oyt ngu euv
uos: nwz lce aow iuq kol
wlp: nck wup ahq csj
fmn: wko ibd lvv dny
nww: vkv drq hcc luu
riz: znu fmz nyv vvk mqo
lch: itp kek ldq
dkt: bkz mlg ckr
dfo: zbb lic qfu omo
unf: qws lsf auy bqs ppc wfa eey umc
xfu: cms jxe ixz
ojc: pnx
hbi: dhf nqb
ptp: ymp dop bkw udg scm hab
cfa: vkp ugl hcl zhm xbq
qnx: vcl jsi rsj drm znl
cjx: avh qqj xer tnj gln pqr xjw
wqq: uba vsn joy
wkv: tap bwg pls qlx
lkf: pbb tnu cgn gdw yrh hzh aey pth mda
zjs: baa
jqp: kbw csx pls
mtp: tjo bjg lah
enk: owv qpq sbm kdc qlx nrc ayh zje
kuo: zyy kkh skx
ydd: tmr tww rfm
txd: llk ixb uct
uuv: udq dot koi yno phq gyf xru
igp: ztr uon qod kol yjx
yzj: vhe pgr djb qgb
kyt: rtd clv dgz
uee: qnr zrv esf xwp
sdk: dpx vuy obs
eof: cgn aak xpd
lre: nop lvc
wns: mxb nri
igm: jqx rwc
etp: rza pcm ttg law jbj lah cmt rui awg
bvm: mlf fnv ads tvl
nra: qxq ojs cbp xug qur
wxx: owi
mxb: sxw tis ysd wns
mlg: niq kja nwp gah dkt cwj
bzc: clv nmb tpr
kiq: byz dgi
jec: zhj okn qvc hgx dgc ojp
mrf: zqg mxi eps qsc
kvg: exe vzx
itp: wsj aqu lch
jxz: udy igz ihc mov pwn yzx
lzn: uts bgq bpo mjj ydd koa ipc
odp: rpw dts gff
wll: zjw kcm bxx xxw eqc ont lpl
too: zbt rje zio lnm ipv
lvv: ybv qhk pbb mnt nak mtp aup fmn ktp dpn
niy: ixq wqg
qsc: hly jty vyz
dcx: izp alu nri
ouz: ukg ixb klh tjr
jbn: ynh nmh
yzx: cms eza bzw
vgi: jrv zio zuv dfv qxg
kjl: udy
ipa: kze tfn
jlk: hcc nkz sqs ayx apu pyg jfz
ffr: koa luu owi eqs ubq vct jqo ptf
xer: cjx vjt wzc
llk: txd tvl ove gym
xqg: aam llc
eju: dft lbj dam
rai: obc hbi
htx: lxn dts qdq
hxx: pnm fqf qxg fim
dmm: dot rdy tuw ryj jbn vwv vkv
nqv: hob njr ryv wwv
nak: vsy qfv juu
tvu: hep jtg bih hcl
zpi: bvg kkh dpn jzq
vbp: zxr mrg zsn
eoy: pkv kcm hgi
rza: hjh etp nro
eom: xug aht
tka: tzc juu zvg cou vhe uyi wqg fig uxp
qnr: nqv kex ahh icn qws xje
vxt: ter exz hax ove fla pjy ovw hcy
qod: igp
fwk: tvu dkj gwz zxs egv nsu gkp vvh
skx: ork kuo dyp ipv hob
qmf: yax uvg sfw
ijm: xmz vos jjm
mtw: keg ayc
nri: ooy wns
mys: wco gqb rgx plh
lvw: hep
pcv: yqm udg gnl skt hqg
byz: qur lnm kiq
qdt: tkj lvi mei tfv rdu apq gsv ijv
lce: vvh zph
tfy: dky fhg pcw pdr dda bzp ses eza gbc oim
gkr: phy uto
rjy: uaz cls
uad: ktp usg jtr rvj dkb qvk rje xds qgo
ggv: tkx vfo leh mfv dde
oug: dog nmq syf sfh zup
hgx: idn krm bdx
eey: euv wsw xod
mov: ahm
fey: bdx ytd zio cox pvf
ocx: zim fqg tzc
hmx: tfa khq hun hlc bjb dop ixq wwv
wbc: bgu uol
khs: ano djn lol oaz thh zjs khk ahq xhb
vpd: olz oim dyz
ifj: qbb inr vcc fim icn
vpc: dog syl apj ord ueq qaz ano dch
zwq: bgu jfi nfw kdd fxy sln qwv
nxb: yig ngv ubq mnx keg qmf
nfw: pug spg
ybf: qef rko
lob: rwc pzj jqx quv fds cms ewx tub
rcd: fwp ago nim zha rvs vvr
iyi: jyk vnd hzh kvx imf tkx tea cgt
dam: gwl atl zwq eju yko
ewx: pyl
bjb: zce dsv jsa dgi cec hmx xud ogc wdi
thh: cos mli hax lqr apu oug joy
mcc: woc jtc zmv eqc
csx: hic wea jqp ptf mph
asc: weg ano kwj izp ttl yns
khk: hcl zew
bgu: zwq wbc pei uct bam
vem: knh jaw ahr ocb
jtc: rai ghk
rql: exz hor sgi xoc doh
rjb: yew rfm
yqr: ldt odu kdt hlm ael tot
cgb: cgt ouo qmc
yog: zjw ilm jaw sxf pud pgf
hue: lfb ywt
vbe: xmz
ztr: otg
bxk: tfz udy oeh cqx
mjj: vmn rtd rka rpo hsh
xan: vrd odt tzv rjy hrs wnp
icy: hpr sgi izd
hnn: jqx cec gzf dhm ngu
gje: age wma
skh: hfz mjd pgr ahm cmt bkw ymp ybx oow
gdw: ewk bxk ixq zsw auy
fyc: mwl vxi uez exb
ukg: heg
jzm: zjg
pei: ehg pkt hue tda bgu
pgq: ccr ipv
eto: axw odh qxj
zyp: ous tkj
fqd: loi uqt pcm aox uee ocj
ubq: ffr nxb wdb
lix: crq wqq fnk lwa
syt: lws uuo eom ewx
rpo: nmb sxf
afx: bwz zvf kxr avh ojp xer dqu cmt
dgi: ahm jxk bkz kiq fcn cpn sys gzy hsy
ors: ldq qtq qhv khq
akg: ynh sln
hls: vqh oql txd uvb
tgn: izn gfy ukn txd
aox: dyp zuv sml ouo
mny: kjw ter cus dfm
vyn: pnm uxp eqw key ccv
kta: oul iud ovw
yth: lbj igc gms ocb yai ove
zjo: oim vvk wwk
ymp: vzo cgf dkt fds cfc
owv: ojt pvp
qvk: uad xib acg
wxf: cfa rmx mny wvt akg ikg now
xml: byw znl vpd fqg zqe
syl: dnh vpc
qdq: nba srv tkr
nck: hmk vww heg xqg srv wlp lmn bsj muf zph eih emq
kae: qws zlf aak dsv
tjg: zpz qbb lhy
pqm: pdr sqy kqs
wbd: qfo tno oyt igo kvx nra wzc hqg vee aak
utj: umx lqp pug yns
nwj: gdy ktx ter
exe: eqw kvg twh uto jgj jfh uty ael tkx
niq: pny sqy
xnk: hgz odh com xiw
uto: muz dlh kuo vcl cqx
hgi: aja eoy
iit: xtc
nwt: egv wxc
ugz: esf hvq pxf
kcw: nlm ige pxr kel axw xir lbb
