zkl: oyo ifh mvk mer ztc tkq rdk
cnz: viz vzs mke gke uxp oky xfw tvd
bus: dkh qzf doq ydy nrt
sgi: mft dhy lvi eiw lhz
sge: mke saw
kbl: bmv fkp sny
vip: wjd caj oof acj tdb sge man xze
yvv: tbc mme etk
ydv: ioj qzu bkg vgg npr
gfd: zqb ggw rdk
fix: mbc smj qsf tbc nrh hkw kaj rtz
ozf: xxq mdz wfr qrx
jpp: fnh okx zpq
yjb: rin yhl tft kzs hzs pje gac lhz wml
dec: vnh ddr fnh dnj zsv soc jpo eaq viz
ejx: ial tgm iyx kwg
ofl: fgr evq
mpv: tup jyg fnx oly
zzc: vyz xqt mqt hhb wmx rzw emx bei
lld: vwo kmr yoj
nke: evq exp rtz
hem: wku oho gxd ouz
dji: pyk
dnj: duq vmn znc jpo tkq
mbc: fzs oge dnx fix rsj gog
ffd: afn oio ear mbc rqv xio
onk: fxm kfa xmw ifj qla
rnr: ira ifh myo qkx
mdf: qzq elz ywm cjh umu gaa rst ulm
sgu: jyz wxp
hdm: bja yoa frq rxy
rzp: ndh ngs
qky: vyz
bqc: viz abu oum ixu lfr slh
fdc: ytb hju yhq doh fwv
kbs: ryu wnx kjr zbp wxw xtx tgm ydq wmw oca ceo
skx: jvp tkj ylc afn ygz iop wtc zzc
bgs: jtv zxf iwu
ddr: gvv dec
kzd: ngk aed
mjr: xzu lxh hyf
epl: vdw mmh
gwp: ylw bvx pxj
hyk: afn ixp qjc hhd xoq fbh
ssi: zjt djd jlk
ncn: gzp ejx uft
bdi: lor tom vma pkp
dhy: gdb sgi khe ypc
pti: qvd sby ezt xhl qkx
hfo: xcu gvt
wvq: isn yis umc quh ylo
cvo: ire mgk jxl
eyq: ctp lxz ltv cez
fia: mfe ela
mxl: bxk aje ivb xli voe wwa cqm
rbo: rmj rdp crf dxm wcw
nwc: mrn zqb hjx
fbq: xdb pxf jto syo esj pyk rhw sti iet yot ytb njr hyc mdp oci
iox: qdi
rxj: ctp now gam ufr uec
kba: qai meh bos xxd bbu rgm gwk gtl
wkx: myp lyf bop
frq: goj ixr mms ohf mjt hdm ayt dmm
dgl: zeu tvh ivw ybc
icd: jdp bmv wce vwn akn jdz jow
exp: bsc soc cnq
jyz: tmq sgu pab iob
bct: imp her xjg fjv
doh: gqp
tgw: imp vyr
hmf: crg kle bid yhf shw
mme: vzs cyx ozu fgr yvv
lpw: uta myu saw
zog: frk kko uyx rzt emr tpk jge jms lix
mku: wen
akn: icd wfq xbq
mvu: nsr kko ifw inx rnt
jjx: gjv ysr sgr yqb
bpt: acn gog tmq mzo aku
vmn: wcw
kjb: qhv vxb raq
oye: zxf czy jxr bcx mke
fio: dmm bcw
vtl: zvr jwf rqm jfy nvz kwm mzi
ifo: hzu yyy tcc qsf raj kle aqy rqv elq pjz
ltm: skm swb ycb fur dfd zua jkt
ndh: aqn yfr
njx: ikq fbt xjg cly
oda: inw pgt ygi pxh gck jqe
sby: pti mwf kaj
ony: khe njx vte daj dbc qsf qks
kzl: onh jfy rcu
rin: ufr snu
omm: pna ckc arm
waw: auz ksv
nfd: rcf akn wne ipr awx jml koe
ozy: rbg tjf mdd
bid: zmf tzs hmf gsh nka qpm
khe: afy ony cjy
mhi: smr bdi jfd jeo
hjz: ttt syv
ybc: bxk dgl hsy cmd lug
ptw: ure pav oaa zkt
kot: fnc ykb wtc aqy fpy tft qak
ziv: amd jjn
fxs: caj xan dfy tyu txb xxx xwz hyp lte akg ycx
mcg: aje tpt dni rtz sef gav ocg xap fbt feg crw qxl lte pjl
fiv: tkl esl zbp
ydq: fjk kbh uel slb yyw qvv ppp flz
jwf: nvy vtl vwn
dfd: ltm vpe gmt
tqj: uec ylw msd wcw mme efp rdp zqb
tqf: lbs kgk
qbn: esj eut iiw naa koe bql
hvg: vgc gay wfl ssl urw
tsx: byk jtv zru zeu gac wju oof viz lau xqt
sqy: pni qnt mpa
xzr: yyr git
pif: nll ide pxo
swh: hht
jtv: cez ujd iox bgs aed wje svj
ypc: dhy ayn
ddn: ujd dhy vmh cyg
cqm: msd ftb
iyx: ejx hwz amv zcw wxz xbq uxo nwj
wlx: wxz zvr gnp
ivr: tyu ybc vdh tft fqn bum ndh
bwq: mgr sfo
jmk: yls jvu lnp bev
ejh: inw zhn igs zwx emh
gjv: fxm kcb
pci: ake rnt mbx fkp wlx elr yvb uhe ilx
wib: tyu gjc bnn pzt ngs
oyo: zkl ycx uav jei
uym: mzi sjv xub yoz ray awx
jfd: zsi osq ega lpt vdz xzu jmk mhi tta
fhc: kwm uel fdc enb nxo ywl huw eyl
ckc: ecp ope
xio: ffd gck gxy iqx
foy: kkj mvu ziv tgt ppi
ixr: ecp frq
obd: mze nau tbk mtk lbv
tpk: eey zog qru vsh syq tup
nlr: ukc zow cmd pjz saw
djd: imx yoa iav nvz wen ssi
wlz: gmu rdp gqx
wez: rcu meh
tbc: fix yvv vte fjv syf
qvs: bgj rvg
udj: kwx gzp tqf kkj
ugp: xoq eoa ufa wnt gql gdb vbo
pry: glp ezt bcg
ibt: ugl zmt pmq jfq lbk
tcc: usr ujd dbe
psj: tkb ksa jwf rrt bno
hsu: clv nol yip nke alc ibg afp
oyq: svt ndh
goj: jig uln lyx
ujd: isw dwv tjg hyp tcc shg ddn vmc jtv mmh
usr: jfk xte fwm
zkt: tvh ptw kyg
mer: buq mwf nsn
jyy: wjw
lfw: kgk uvl yqc ngr orw kcb
buq: kdk sgu mer ozh zmf vij
mgr: pmj bsm ocg exf bwq
tsy: wjl unn udg dyv ppi jpy
yoa: rnt huw pna sri
pvp: ern xwl vbw
jvp: ivb siy wlu skx ojm nok ulj
mzo: jyy fjd nyz ydv bpt eaq mfq rho
epd: skn tih lpt fws
bif: hia skk umc nok czy
yfr: dnj ulj kta afp wjw ffe jei ndh
woz: znc lkd ozh
pxw: rrt
ptg: gmt xce qve fzy
yyz: npp frk ppi gvz
ius: cjo eoa
uyr: unn
rrt: gqp bmv pxw
zys: vwo lzk yvb uuv mfe
mvi: dcm cmd pti zpq fsr
yir: lsy pki iav
ial: hsu ejx aww vaq
dtp: ewl
vyc: ucs lrc txa wem
elg: pas aku vij
crw: sax ycx tvd mcg
gbv: agt nvy hav
tdb: zji dxb mue zwx vip
woh: ugz xxd ltk
vqz: pui rkc
uvs: ogn umu oky rxj ocg qlv yjt cmd
rsj: gxy mbc lug
vmc: yyr lqf yfr epl qkx hqr fsr lau qwp ujd uxw ubz
zmf: buq dki yyy oum bid
zow: rkg qxl pje
ifh: vbw qxl wbe
bsc: yxl ghy exp rwm
bbu: naa vdz jqv mbj ucs
ayn: hli ypc ezq
vko: wnz pfe mfq
hwi: uft gwk
zqn: dwo hok dha pwj wbu pjz
rxy: djf hdm kfa paj
enq: uft uic gbv pma wxw qrv
fss: ehr hsy cio faq ztc
crf: lbv rbo
zyi: uya djd imx fly qbn syq qnt jnv yfj
hli: oky ctp mqt ayn man nyz rnc tft xze gkw
qlw: wfl ear wbe viu smj
quh: rzp sef
iwu: ywm
xyn: jkt upz hae qzf ohf vzy kqv zlt
bbj: ivw mft pti ufb oyq nau qrt
vju: dup esp mzi pyk
qny: sib dle ylw
ctj: pjl dlm rnr qny zow kzd wif gkw ibg
oyw: kex gwe
uma: rjt hqr oge pda
iop: gbr dxm
gux: gxy gsh pbh
bgj: tqy ytk yls dji qvs
duq: ndh rnc xap iqx
ctp: lff djw wfl epl rxj eyq azn
sti: gzp lyx yvx
jed: zcw efn qrx rgm
diw: gdk upz zys hip
mih: xqt pbh ssn gog dcn
osq: fcm
csy: mmh gql ulf ztc sib zqn mtx dwo
evq: txv nke ofl pib ezt
uas: uft ela lhr
vih: eia vnn kkb
hic: jml vih ycb zcc hjz
qhv: eut zmd kjb ove hju gsj woh
ezq: ayn rgq jxr
nxf: oof gdb bsa
jbf: kmr sjv pif bdr yjm rrx wri hcb ayt zmq cfn
hqr: lki dkf qxe lpw qkv cly zjm tpt uma svt rkg
shw: hmf yba akg coc epc mtk
qxe: sze szo
byk: sby vkf lpw vmh swh tsx dfy
fsi: txv ufb lip phn cof
ppn: cgm wgi rcf fjy vju ptz ucs
gmu: rdp her wlz
fbt: ukc
ffv: yll pgl myx wlz
daj: ony
hzs: mys qzu ltv ipo dha
vkf: puf ucc ybc byk
lmo: lsy vpe ptg usd yot uvl slb bop kfn dll
jol: hmx tut aib enb yls gqp ckj
rmj: wmx ghy fjd fnh ogn bvx baq
yjk: yoz ptz khb qsq
elr: pci rka
uln: jpy rzt naa
mfe: fws xbb
jge: lwm kpy mdu zog nvz zec ake lfk zcc
aje: nfe mxl jec
bsa: wju hku dxc osg yhf
vzy: xyn
iww: qru
pho: sfs
fbh: cam mtk
blf: mwj qsf afn imp
jdz: ucs oyw sko xxd
lhr: ttt oyw uas iww ikr
gif: kmt bsm lff tzs pjz fwm adf ojm
zdl: cir flg daj
ekn: gqx
nok: vmn bif eoa mcc hsf ggo gmu
mix: hqy rqg tgt bqo xaw gqp
lyx: xmw uro lld hae sti
qtg: skk njx stx wju
ygz: ius skx yie sib bgs mrn rnc teg ykt
cxf: gav szo
vsh: tpk may iib
efp: cxf xwl swh
tvh: mpp rpl dgl mif dwo
sck: flg rnd wdv
gmz: wce myp ziv elb tyb our
sze: qxe ioj tmv azf ori ynw hcm
hhz: rpl aqn
cly: zqw ori myo
ttt: lhr hjz voi
ysr: fcm uyc foy zif kjb nbz jjx
pib: ifi
aqy: kot
wcw: rbo vmn zwx lao
gdb: acn nxf ugp dhy
zsi: zvx pxf xbb jfd sdm ppp zbp qla
ikr: dxf tgm yio lvh rka dlv lhr ybs kbx ltm pjo
qij: pry qkp vlp mme
mbv: ftb pfv jpo efp xrc hqr quh mum tgw bxz ykt raj hia
xqt: zzc jzq ssl mpp mih zhb mfp vdw
rwm: smj ynw fqn
xxx: qmk pwj pav
ebm: fkn
uke: pee cwf
okx: pda gxy
zcc: hic lbk jge
xcu: lkr hrm hfo ryu mpx sjv
jjz: bxk gkw myx fsm ulj ulf ylc rkg
mrn: ykb nwc gmu pom rrl
smj: rwm ltl dgl lkd
yio: ikr pma rzt usc rew
exf: xfw xan wtc
tma: ppp lbs zvx lyf
wtd: azf jqy vbw oky quh bsm zsu
xli: jqy zqn rzp
eia: kzl vih vdz syv byi zwj diw exl
pmq: ibt eie uas kkb pma lds
lff: ylw clv daj lki gif
coc: cir wyi gck
ujw: rqh ntg
pxh: uju zru otd pol oda peb ius soc bvx
zmq: edv bcw jms jbf vau
ysc: kkb gtv
ihx: fzy pcz bhq may gvt ksa veg ihk
dff: xxd myp yak ynv
fcm: ysr osq
zqw: cam cly
myp: jfd ckc ifw wkx dff kdt ove qrv qje zpz
dmj: pfe ure msd
pfv: slh
osl: qhi xlp wjw rdk lfh yba cio vmh fjd nst
fdm: mzo ehj nrr dbe vnh mmh
sfo: cbz zpq
umu: ehj mdf
oio: jen rbg pib yyy zhr ekn
ywr: cov syq
azf: zkt vyz etk inw mdd
fwv: jfq woh cuk
mwj: hia igs blf cam gaa ktv dlm
hsy: mtx ybc
jck: wsi pas iuo coc emx vcy djw
rgm: ytb jed
qhi: yps ozh
bkg: ulj
cta: fnx usc yxc kbx osq jdz kwn
boh: mbp
xte: jqy zyr snu
xlp: mlz osl smq gwp
qsu: ifj wbz
bhq: iww jto
ikp: lxh hwi qjn
ugl: gdk mxx ray ibt inx fpl lwh gvz zcw
ysx: fbh qmk tyr gsh
slh: pfv oxh qlv waw elq bqc
ugz: enl lld vwn gtt woh jed pmu pkp
ide: lqj nng pna mep pif pzi emr xhc
git: ngk pzt rjt sel msd xzr
ufq: pnv uhe mbx
isn: ozh snd dle fnh gjc syf
mfq: mue ndy tft mzo vko mvk
koo: ucf dxf yqc kkb
pas: rin jck tjs hqr elg ptw now ear crw bum ymf uyr
mum: mbv hsy pgl
vwo: pkp lld fjk bri zys
sob: zkm wku nvz ipr pnv edv
dal: pxw jrb
ivw: dcm uqa alc dgl kta stx
pzt: elz pva jyy
kdt: tgj qwl pki cwu
odt: iep vmh crg owe wju
uwj: kmr fzy qwl qxx wgi
szo: qxe vko nfe cxf bgs
yvb: abe zys jjn lxi
kta: jim ivw
myu: hzu wje
viu: txb ysu yvv
qje: frk zyi ate uya szx myp
enl: ugz hwi gjv agu uwa cbw
qsa: gwk ihs abs fkn
zvd: hsf rqh twm efp bcg
efn: kbl glg kjb wqe lwh jed pma
yim: dgf ywl hic dxf ycb
flg: lip zdl ewl pvp crg rxs sck ehj
emh: ejh ozr waw cbz
ykt: tsr txv lex
hcb: qjl
mbw: fxm vau qwl
mcc: mtx ndh qsi sax
wce: icd uvl
tkl: rqg usc kqq
skm: ltm pjt agt fjy vpe
ucs: omk vyc jdz bbu fzy yki sqy
lpk: jdp jvb ilx wen
wxx: clb ezq pgt tno dxc
xlw: dlv yfj wfr akn abs
bkj: gql her kzs urw ttb qak xyy
kpt: ecp kup pms mxx
otd: pfe sfo
lmv: drt mgk hip tup
wju: ksy gam
qxx: uwj yjk
xjg: njx sax rnc nsn zow
kfn: bkq cbu hwz
wne: ydo
guy: xhc sgc
gkw: ctj mdd
lkx: aww tgj dji rhw
twm: iwu zvd uvx ghy
dkh: iod drt bus kke
myo: mfy waw cly
vry: bwq ykb ikq wjd bqc
orw: xpi fuo lfw qvs qzm wfj sqb kkf kkj
wgi: cad uwj osq kko vwn
bna: pjz ulm mih wst pvo rnd pry
ftq: dyv wal raq ale yim kbh
ycx: oyo ezt crw fxs
sko: ldw jdz tqy
uhe: ufq pni
nwp: npr
aal: gxm
ltk: lor joc woh qai mpa kqv
wvg: qrx hbe dji sqy nbz yzz fxm rrx efn
pje: lhz zsv zow vcy twm hsf
sib: mgr ygz
shh: exf oda ylw oge txb
bql: qzf tgt qnt hjz fnx
iav: yir emy awx djd ngr cad
rmg: lug pte rqv zhr tyr jei umc
fwm: wek
vsv: isj cbw jfq xhc
rgq: yxl iob ezq
qkp: ktv kta fnh jyz bxk qpo nuw
wbz: smr qsu ppi psk uny ope uqe
kwx: fsq udj lnp zxa upz kkf pcz ebx uyc
xoq: ugp mtk jqe
qla: wxz dal rph
dni: tfl udy mcg npr
npr: big ydv
pwj: kle
hhb: zzc pxj qrt
tgy: ufj pxo mjr rio lld gqm
lao: rqn bum ymf ucc
eoa: ftp hia ius nok fnc
dkf: wbu gac hqr
ipr: lix guy nfd dfd iav qzm sob
nng: uvl zlt civ jpy zys ohf
akg: zyr uqa nnm fxs
zlt: xyn yoj kbx nng zxa xpi ptg
fsr: vmc mvi ear mzo jqy
afy: udb bnn khe qjo swh
vni: bjy dkh wfr oci rse ots oho
exb: nrk jpr ebm
pvl: skn mep qve pzi yoa
isw: teh udb ylc ujd lyq
bcx: bip
sxb: hcm svj dxb gbr
lex: lip cyg ijl jec acj tfl ylw
mam: uta pmi hkw bpt yps rxs oyo ogn
quo: mys cml aqn msa
txv: evq
iat: nrk
yjm: wku bja qsu jbf sdm
ifi: pib gam xdv
yie: yjt czy lfh ydw fsm ymf
wmx: vko hfx mue rmj hhu
gxy: teh gux rsj okx teg ufk xio
kup: kpt jog hae uny olx
ygi: vad teb oda vdh baq
njr: uob xpi rrt
qrt: jim hhb hpu elg wif
esp: vxb kwm
mgk: lmv gqm cvo ytb woh efb
wjw: osl mpp lqf jyy
jvb: ots woi lpk sgc ifw
nrh: raj ngh nsn iwu tpt nka
qsf: fix ifo
dmm: bgj bzw fio vau uxo
svt: wfl oyq jfk fzt sda
dlm: ctj dtp qzq hht tbc
ggo: nok okx
ixu: elz bqc acd qks
kkb: tjx isj khi pmq
kqq: fkn yak bev tkl tpn
oci: adh lmv djf idy
yzb: ffv owe fet rgq iwu
eze: bei exp tnl mys ylc gql
xpi: uuv ume zlt
dup: zmd vju gdr lmo uro hcb qjn ale
raq: hyh udj rzt rhw rxy wri kjb lzk
vlq: doh wlx cak vxb cwu
rqn: kzv djr
qlv: slh rjt
mmh: jzw epl yyy yll csy ujd
voi: gwk ttt cuk zro
lyf: njq wkx lel oyw ksa tma
ibg: cjo vdf lfr sge
uob: yyz cgm fio sdm njr
xxd: tom guy woh ceo hyh dff uqe jdz
naa: qbn hdm hav
zau: jyg yvb lfk vsh tpn voi bop cbu gaq
vwn: icd ugz jpr iww awx
vbw: pvp ifh
wxw: kex spr ufq kbs jpt ilx
exl: jit jml zxa eia dji
dbc: hku cyx khe ixp ony xze dcn
tjs: dki ylo jpp cjo vgc mif dpl
fjy: skm kbu ppn abs
iob: rgq jyz jxr vkf
pxo: kjr
ylo: ggo owe udy vyr
jyg: wku naa jjn jxl
imw: kyg wcw ipl rgq wml lte
lki: hxz lff bww wwe hqr
jqv: efu hmx dfd doq
ern: pda nnm pvp
boa: kdk
zua: jfq
zvc: jkt
nwj: yzz nto sgr qvv mku
ega: jfd bja olx agt vgo rew jit
bnn: xjn wnz zsu wib
jkw: vyr szo
lfr: ibg pol qpm bqc
kmt: bwq nwp gif hcm xwz ndy qqp
ldw: mjt tpn rkc vpe ape was kfn bqo sko ass
tbk: zkl rjt obd msa ftb
sgr: hhj ywl jjx iet lmv
pjn: ybs
bxk: znc mxl ybc jqe jjz
abe: nrk pna yvb lbk
gtv: jig uvl
xub: ewo
afn: skx hyk blf ffd
qsq: yjk odv iiw pki
zyr: akg vdw xte pwj
eud: bdr jpt gsj cwu dmw wjo xtx jog ftq
xhc: tqy omm glg vsv cfn guy
qwl: ewo
ucf: jig khb bbu fiv koo adh uvl
sjv: uym jbf
nrr: nuw her fdm snd dwv wbe cir ivw
pjt: orx skm ake
pxj: hhb gwp
wyi: coc zpq vte
uxw: byk uec mlz zeu mtx vmc
agu: ape esj hwz asp kpy enl hyf lix
dgq: wwe faq rpl nwp ori zvd fjv
onh: hqy sri oqu hfz lqj kch
ymf: lao dtp yie pas
efc: bkq fyr
hjx: nwc mci qsf tft
kaj: abu fix
wem: ifw yxc
lkr: bgj kmy xcu tgj
bum: bkg pas lao
kwn: cta dfd hae pjo koe ufq esp ptg
yfj: jrb ghq uyx
kpy: ggs agu
teg: gxy bss ygz coc tpu wjw dgq
wjd: zhn aqy abu rqv lkd
wtc: fet epl
jpo: dec pom dnj
ele: ulm ngh yps wnm klw qzq
cgm: sny uob
xaw: ate ihk cvo
kch: onh vwl
byi: usc yio drt smr
afp: oof
dbp: cep jnv yhq wen kbh sgc
her: nrr ijl
dll: lmo mku
xce: mkw hav bnc rqs kjr kbu isj ptg
gxd: rew fpv ufj hem
sxv: qxl wfl wbu zhr wjd
ltv: eyq hzs gql pib
pwl: yxc wlo icd vtp wfj rkc
fjv: puf
vpg: lvi wft mue dcm lfr iuo
hqy: cbw yto mix doq onh jjn
emy: lof pki vih
sqf: ntg qrd cbz ylw tyu
mtk: fbh xoq hmf
ghy: pwj tjf rsf twm oye bip rmj bsc axu yll
tyb: mci
siy: caj tpu npr ftp ufk jvp
voe: bkg gsh zqb
kwg: veg hfz dmw
meh: erd omk mdu ckc wez hcb
mft: teb hxz nah
lxz: cyg yll
jfq: ibt zua bje
nst: osl tpt hhu sge ruh
ngs: dxm wib
azk: cov fjz sjv cux fnx vyc ale
zhr: pmj oio
kct: lmk wps
jeo: nxz tta gaq mhi geg gvt
tkj: cit osg ufb obd skx hhd xpf
rew: esj ega
yps: nsn ele ddn qhi bkg cnq jkw mam
wdv: dwo sck wyi oaa
sny: vtd ufj syq wne cgm fuo yki emt ghq kbl
fkn: kqq fuo lor ebm koe qsa uya
hju: fdc uyx whk ksf qhv
ydw: lbv xyy mpp yjt
pda: ehr mft ear uma okx ern
wri: raq boh cad
pcz: rcu ycb
cad: inx iav wri wgi
dxj: elg ngs xoq ufa tcc hpu boa nuw
fej: bcw syu lrc kgk vtd jfy dll zif qxx syv vtp
lsy: nbr odv huz tgj
vad: cxf ygi lff xze vdf jfk eaq fzt
ohf: frq uwa
axu: iqx wmx fet hhu
txb: sca fxs viu shh qrd
laa: fnx mdu xzu ggs bmv kfa iwi udj xmw
eyl: jvu jit bzw gsx
orx: kmy pjt rqm
wfr: vni gaq yoj
cmp: var yaa bnc gqm sqy mci
viz: cnz tsx bkg mze zru
cov: gmt dai gvp iat sko ywr aah
erd: nbr uel yak eie wlo bje fly
tmv: saw ffv sze
dyv: efc ftq jyg
ate: kjr qje yoj xaw yaa hfo
ozh: woz glp isn wps qhi
mpa: rse sqy
kyo: yoa esl qai wxz dll mip
jxh: ssl bss nxf dxj qkx usr lhz hbk
auz: bww waw dwo phn fsm tzs
ycb: pcz jnv kpy
omk: iod ebx
gsj: eud
yqb: orx yaa gdk
dxc: qks ulf bei
jnv: dbp ecu
flz: yot was esl
smu: pxf vac erd
vma: bdi lix ufq esl
yjt: yie ffe ydw yyy zyr
uic: enq kpy mdu mkw
nsr: oxl mvu adh
pna: cdl yoa abe
mqz: qpm jim wnm zxf uvs bpt qjc zhb wbu dxj
czy: oye bif
uxp: ehj teh acd
kex: nsr cbw kpm nbr kmy oyw wxw
zma: kyg gnn baq mxl mfy
fpy: nuo
ihk: xaw bjy tjx yzz
lte: fxs qjo wnt
syq: zyi tpk sny
ggw: ikq gfd
fjd: ure osl
crg: bei nuo ksy ern hmf rst odt vlp xwl qsf
oki: rjt ozr sel pee
xdb: zmt qsq dnp ynv rrx
vac: vlq lor vwo smu asp
gog: yip
mpx: xcu kbh
big: wwa ifi nep mtx shg auz npr
olx: tom mku mpa
clx: pyu rcu pui pkp yls
jdp: eut boh ape
nvy: uyx vma gbv ucs tma jwf syv
kdk: buq boa qvd
yis: ynw cam wvq dwo
rho: wnm
hwz: hyf usd zvx kfn agu txa qex fkp
esl: pnv hmx
gnp: szx sdm zec yks wlx wkx qjl ngr
dwv: ufr wqw oof iob
vau: our woi mbw
qsi: wek mcc jim snu kle
pzi: gwe pvl
wst: sda nsn
teb: sck ofl mft
rrx: wvg udg edv
kqv: ltk cbu var dgf wez vac
fqj: tgj osq vgo oca ope wem zkm amv
xdv: hvc rrl dpl kaj
gvt: kwm jml
ghq: iav whk yfj
fyr: uwp abs gut ixr efc jdz cux fxm bop
tom: rph
fly: sri zmd erd
gmt: dfd
vgo: xxq ega fqj lof
kke: lvh dkh qsq
mdu: sri qve jge
lau: tsx mfp smq wsi
fbj: fio xxq mbx
ssr: ayn cqm ztc otd hhz tjg ilv
mqt: qzu zzc hli ivb
jfk: svt jqe wvq vad hvc usr
mkw: xce erd ljo qla nxz uic
kko: zog wgi rzt
pol: cnq wnt qxe lfr ptw pxh ggw gmc
gtl: kcb
ipl: tpu imw yri gwm mwf
smq: gxm xlp lmk dmj ylo lau
nfe: rnd
gam: ufk zsu
pva: pzt jpp nau
abu: bqc kaj acd dxm gmc
vyr: ylo dkf jkw umc vgc tgw gog
yaa: cmp
eey: tpk asp oca abe
uvl: iib gtv
zwj: xub mip lxi vtp eia mku
iwi: pxw wqe hyc ypm cgm smr
gav: mcg boa ure cxf zxf
ztc: mke csy fss zkl
var: ale qrv
emt: ytb kfa sny rph wfj
ueg: ysc uvl lwh syu jml fsq wen fpv idi amv
ipo: vkf qqp exp gwm myo hhz gav hzs
szx: ouz whk emr swb jog gnp xvy ecp kcb
cio: mlz fss
gql: ugp myx bkj
cmd: uvs mvi viz nlr ybc myo jqe
vcy: jck pje fgr qjo
yba: shw qtg gam pxh iop gwm
fjk: lfk ydq dai uln
civ: zdn pfb
tgm: ikr ejx imx
asp: tup zec eey
xyy: xfw bkj ruh
ceo: kbs hip amd wku
lix: vma agu ipr zog
sel: rbo git xjg nwc rqh jxh rnc pvo ipo cmd cml oki
wlu: gaa bxk jvp cxf hpu zdl mze djw qtg
wfq: pki lvh ouz lds iiw
nrk: sgr ape lbs abe iat exb
mvk: znc
osg: zjm ira ure
xpf: qtg cnz xjn wgj vlp
nuj: mvg vas nka txb cit pmj
awx: nfd ecu mbx
lwm: boh ebm jge vac mjr lel lds zlt
pms: uel
kkf: lkr iat iiw
uqa: ivw dle
kfa: usd rxy tup yoj
ezt: ycx clb etk gmc evq
yak: oly lds kqq
eeb: wez bri ppp ywr lof
pki: glg
irj: ele zqn buq pmi gmc hjx wml lqf
xsi: wgi cdl bmv wen eey rch mdp gxd khi jvb
ilx: pci
yhf: lyq teh ehr dxc hmf gwm
npp: yyz kmr wne
qzm: ipr qtl
efu: jqv vzy ywl pif
tpt: nrh nst dhy iqx mcg xan
rdk: gfd zjm
pyk: ouz scm may uqe vju zif dji pjt mpa gdr
ksy: fnh mze wju wje ngh
kkq: ufk msa
lkd: alc woz
pte: djw hok gvv rmg
vdf: vad
pmi: cjo zsv dha ltl
flv: mms pms epd vwl wez gvp
sbh: skk eiw hyk rsj
ubz: dwo nwp xhl
edv: fsq
mzi: hbe mvu pyk vsh wnx jfy uym vju
whk: kmr
ira: bsc tmq hxz iox osg rnr
zhb: zji oxh lmk
jpy: tsy vxb zmd uln wxz
xmw: njq pfb meh bmv lyx jqv
dxb: acn jfk now mfy wgj sef ixu tdb glp sxb jim
acj: ufb pxj lex lip
kps: emx xyy btj now
jjn: ziv lrc yvb kpy
eiw: btj sbh
ufk: siy kkq fpy gam wek
gaq: joc nrk jeo kbu kwg fkp wce vsv fuo wfr
lnp: kwx sri wgi jmk
mze: obd
smr: iwi mhi
ytk: ihs
oum: zmf hia rsf
tjf: pva ozy dmj xzr ghy wtc
psk: kjr
qru: hwi izg tpk mfv kqq dal zxa cbu iww
rvg: sgc qvs rdi gtl dmw kwg hfo yes
nrt: bus ufj pzi wlx
pxs: fcm ass ove kbx esl vqz mjr
rka: wpo elr
udy: ttb vbw
ynw: kzs oky rwm yis
syv: ass eia fej fyr cak nvy ict bhq jxl hjz
kjr: xce pxo psk
mbp: ape xdb lpy rph fjz gmt boh njr
fet: xyy axu oda snd cqm yzb zdl wtc iuo txv
doq: xfb lvh fws
ruj: rph
mpp: ruh tvh rlj uma ydw wjw
qai: kba ltk ydy
yto: jpr wez pjn uro nng
rnd: bna sck soc mer nfe hsy rdk saw
ksf: bos ksa
khi: gdr
unn: ozy ltv uyr snd siy vcy dni imw
myx: ffv bip
nuo: wps ruh fpy wqw
ire: jit cvo
dai: cov kcg nsr
vdz: bbu jpt idy zdn fwv
jzq: nau hok
nhm: njq geg
yot: fbq gtl ega fuo uyx flz
oca: eey gvp
pyu: clx izg veg
wnz: klw vko vgc bnn wek oyo msa njx
lzk: raq nhm gtv
jxl: aez cvo
wnt: lte bcx
mdp: pms ilx jlk wqe cvo
cit: tkj
nbz: tjx wvg qrv
pxf: smu mci lpk qjl fji scf
abs: fyr ruj qsa ela
rph: mbp emt tom ruj
agt: uuv gbv
wxp: vij sdo ocg hsf fzt pgt afy sgu nrh dmj
fzg: nxo emt vtd hem ruj
ynv: uuv kbx jto dff
kqo: xqt bum rjt rqn iox cjy gsh
joc: fia adh ict
ppi: wbz tsy
ywm: hia iwu
wen: lpk xsi
kyg: hzu zkt smj clb pgt
zvr: ume zcc dlv fjy wlx
pom: mrn jpo fsm mwf pbh
raj: ifo ssn zqb mbv ndh
zdn: civ aah tkb vdz vpe
bwi: olx wri uel pyu
scm: pyk gnp bnc kke vpe qrx mep
tvd: crf pte cnz etk qmk
clb: ksv ezt
sca: kzd gac caj wnm git fbt txb
ehr: pda ntg sda ulj mbc fss yhf ghy
emx: swh kps kzv bpt
jig: emy bzw ots qsu gtv
dlv: zvr rio cux cfn uyc fpl xlw eie wkx
soc: pxh vmn wgj exp ijl
qrv: ifw diw myp nbz var zvb lmt ypm dmw
wnx: tta slb
pab: oum dbc wdv jyz nrh qqp
zcw: upt jed ass vwo civ xbb
btj: inw eiw tgw kps hok
cuk: vau voi kwm fwv bqo bzw
qdi: alc iox
uft: uas bdr jjn kgk enq oxl hwi
mfp: fnc cnz gwp rzp lau msd
nll: oly bjy pif omk
pui: huz wcc iet bkq clx vqz
ftb: hhu hcm fbt tbk cqm fqn
hrm: gdr guy geg xcu jjx var ttt qjl
dpl: qvd qqp
wfj: emt vtp gmt ghq cep pwl sqb fji
tyu: fxs
ltl: lug gac
zwx: ejh
znc: woz mvk yyy vzs zsv ypc vgg bxk peb
pnv: elr bev upt vma ziv esl ufq
oxh: hvc dtp slh
ntg: ujw tzs sqf ehr ilv
ufj: tut tgy sny elb gxd jjx nrt dal
qjl: fji ove gnp hcb
hpu: wlu ogn qrt
wqw: rrl dwv dfy nuo nfe
oky: wtd fnc
gck: ggo oda xio
rio: dlv tgy ypm
zhn: zeu glp
dwo: ubz ggo wdv xzr yis tvh auz xxx wps csy
ywl: efu
kbx: wem cta pxs ynv iiw
vpe: scm dfd lan skm zdn
pfb: xmw kbu cdl civ wqe
fji: wfj bwi jpy jow qjl zec
cbu: olx kfn nwj
acd: abu
nuw: cjh nrr
tqy: xhc bgj oci bno bzw uny sko
jxr: mvg oge ezq
ots: vni cux
aez: jxl gaq qje npp kke enb
dki: nep zmf cbz pxj hzs
vgg: tvh vdf bxz ydv lxz rrl znc
vij: gqx wxp buq
wsi: lau jzq
ray: ayt uym azc doh
uec: rxj pva coc mwf uxw tqj peb
cyg: lex lxz lqf
lpy: bql hyh rdi yaa lkr ots uob
udb: iox eoa iep isw emx txv imp afy alc
cak: syv adh bkq
lyq: yhf isw lqf yyr mvk hhz
mys: osl hzs tjg quo uvs vpg eze hok qhi
rzt: ypm kko
jms: emr
huz: rqs mzh lsy pui
zeu: rho zhn dgl wyi
sqb: wfj tjx mfe orw jvb
gdk: bev uny yqb
kwm: vtl gvt fhc esp
cgx: kzv dtp kaj ydv vfb aje ori qvd hxz
fpl: rse
tft: kot
hhu: nst gsh
vlp: xpf lxz zjm crg
wal: aww vtp
ufr: rin wxp uta rxj ybv tkq stx dwv
qjn: jit ikp iav
rch: ray edv fyr zbp
emr: ide jms zog
qpo: zhn qjo cez fnh lhz qkp
cux: dlv ots boh
kmy: orx kex
eqp: jxl lfw gut mpa mbj xhi ume omm
gvp: pap ifw rse oca jlk gvt
now: kps rxj
hku: ksv bnn
jkt: txa zvc ysc mjt xyn efb
uuv: udg agt xpi aww bmv ynv
bjy: vni kch nll ape kmy ihk
cdl: ict pna bdr fpv xsi ksa yak
stx: qtg
zjt: qvw gdr uqe wjl ssi sqb
zvx: ebx nvz hwz zsi vzy qex mep tma ysc xcu
xhi: ydy lxh ilx fkp eqp
gnn: lqf qsi bct gke kct
ikq: ggw
bkq: zmd pui cak efc kfn
sgc: guy rvg bje
gqx: wft emh fgr vij qks ibg ysu ekn wlz
eva: rnt itl jms rqm
bcg: pry alc kzv zvd
jec: nwp aje zpq ftp
iqx: axu ypc xio
ylw: shh ekn gwp qny
acn: duq bsm elq dxb pvp gdb hhb oge vcy bpt rax
qzq: ele
zsu: gam bnn tsr
uwp: fyr mxx gqm rcu vaq syu fia
ecp: szx kpt ixr ikp ckc
fuo: sny wcc fkn
ijn: fnc bsc duq hzu bwq tcc vko
xbq: iyx tgm aib
ulj: ehr jjz bkg
oly: mbj nll rse pjt nhm yak mpv
ppp: pjn tma pna
mwf: ipl pom
gvv: vdw vdh pte ddr
sdo: feg ktv
zmt: ibt mzh ikp
cnq: ltl okx dhy exp pol nuj
lqf: irj cyg lyq
yip: sef clv mum aku hsu gog
wqe: iwi
ktv: oof
qrd: sqf ruh stx kaj
tyr: lmk bnn jpo
pav: xxx bip uju
wif: qlw
shg: wwa vte ujd ltl
mjt: ldw mzh kch rqg zxa raq frq
veg: kwg ljo pyu
dcm: ngh ivw
cml: otd rlj gav ggo quo teh ykt
jqy: oyq xte fsr zsv fzt pzt ozy rdk wtd
huw: fhc ayt khi yoa mhi pni
ayt: veg ray
hia: yxl eoa bif oum ywm
ffe: yfr
lor: yqc lan mbw lxh ucs bdi cwu ass fkn ckm vac
gke: gnn pee
qks: ylw dxc uqa ixu
lxh: mjr lor nxz ikp
hav: naa xce gbv
jpt: eud amv ejx rph vdz wxw cad
rcu: pma wez lhr kzl clx pcz
ale: amd var azc gtt geg ftq vxb
qvv: khi usc
lan: lxh vzy jvu vpe fcm
wjo: eud ytk iib var pmu fzg
tpu: xhl siy xap vyz
egd: abs ybs mhi vnn dyv was bus
ouz: szx hem ytb jlk pyk wfq
nsn: xjg yps nrh
xrc: ghy sax qqp mvk umu oda
vtp: qhv pwl zwj lbs wal ydo
lqj: mci vgo lrc onh
vzs: qqp wdv ayn znc
tut: dff pna lan pkp lel agu
mbj: lbs vmm bbu kkj bhq oly txa ecu
inx: mvu njq ugl ibt cad skn elr
ure: osg dmj ptw
hyc: voi fbq ope aah iwi zua idy oqu gtt
ssl: xqt gvv snd
izg: pyu
skn: epd pvl pxw inx gtv fzy
ysu: gqx iqx
wml: yjb
nau: obd bbj tyu pva hvg jzq evq
zif: ume ysr
mxx: iat kpt kgk iiw
jfy: mzi yzz
jto: fbq ruj bhq ynv npp
uro: lyx yto yvx kup mpv
scf: gtl fnx fjk kcg ruj
fnh: qpo qkp ksy jpp
ojm: gif hok uqa dcm ssn
upz: pxo xyn
wek: wnz fwm
yes: nic rvg mpx tta njr odv doh diw oho kke
tih: epd jit jml qsa
kgk: fej iav tqf
rqg: rio woi mbw tkl zlt
cjy: rkg ngk khe
zec: jge hdm asp
zru: rax pxh
rqs: wlo huz qvw xce
pgt: kyg zwx wxp
geg: esp itx lyx jeo nhm
rkc: vqz ldw qtl bop skm efn rqs esj bzw qbn ytk
qak: xli pfv bkj pxj gnn dbc
gvz: bos yyz qsu
gtt: ugz hyc
jim: kta xdv qrt qsi uju nnm
mdz: mfv ttt fia ozf ydo bja pcz
rrl: myu mrn xdv qrd
pkp: pma tut vwo zua bdi
ufa: ugp ssl
efb: fkp
rpl: ndh eiw tvh dgq rxs hhz
lvi: sgi ozu lki vpg vnh ogn
dha: pmi
rqm: orx gjv exb eva mzh tgt lel
ulf: jjz csy
yhq: rcf woi
gdr: hrm pyk bgj khi hae
vaq: amv ial
yzz: jfy wvg
bvx: epl ksv gwp
jpr: ots hju vxb qvs exb
wxz: jpy iyx wlx mpv qla
spr: wlo kpm eva icd dqm jvb
lel: lyf tut rqm
mms: vma cwu flv
gsx: cbq yoz nvy eyl vnn
yhl: eze rho ioj uvx
yoz: arm rse yjk tqf hyh uym
jzw: faq baq cit uta mvk ozu svt mmh hku
ksa: ksf lyf bje cdl
gqp: jol mix rqm xub enb rrt cta ekh doh
bri: vwo sri eeb xbq
wft: ngk ffe zwx
pvo: qks sel
lxi: zwj jqk jvu
nbr: kcg lsy yes erd yzz kex bja lof ggs
lbv: clv ngk crf ydw hbk ysu hhz
xvk: lzk jqk lof rdi ewo mip lor
ngh: ksy
gbr: iop lqf vnh sxb irj isn vdf
djw: wlu pte zhr pfe qny ozr
svj: ozr zjm sxb nep
bmv: rrt uuv icd kbl laa rew
frk: fbj zcc civ jms zog yyz qje vni
kzv: bcg sib rqn ulf emx
dbe: fdm cjh pjz ykb
ebx: iod ncn cuk bev izg xxq omk upt
hyh: lpy
elq: slh jei
eaq: fbt dbe
umc: vyr bif
tzs: gif dle ntg
ict: joc kbx
sfs: tbk ksv mys snu pho rtz hhd kzd
iet: fbq
lfk: zau gwe
adh: nsr oci cak
hyf: hwz
gjc: xli ysx wmx kdk zhb odt gam clv wib tno
gwm: ipl
bja: mdz yjm nbr tpn tom
kbh: yyw dbp jxl ydq ftq pjo
bje: ksa erd
snu: mvg qsi
qvw: smu bno joc ozf sgc vyc zjt uym
snd: isn
lug: ltl ybc
yyr: bcx xzr
ndy: ybc mfq kmt qjc
wwa: cio shg wst dha
lds: pmq yak
yls: jol cfn clx
epc: xwl elq cir shw ucc
hbk: lbv qdi bum lug yie zkt pho
iib: djf vsh
imp: udb jmj blf tgw
qnt: may bql wpo sqy nll
zji: daj hqr wtc nah ufk zhb tdb
caj: vip ndy pgl fsi kle siy
vtd: sny aah
gmc: irj ezt
qtl: ngr ziv rkc qzm cad fio
qzf: flz jms
nto: bwi nwj bos lkx fdc xhi pui
puf: dle vkf sax urw fjv
gwe: lfk djf ywr gqp oyw wxz emr lnp sti pzi
ake: pjt pci
aqn: ndh
hzu: clv pwj myu
rst: crg ayn wjw phn
vte: ony hhb
nxo: yls fhc udg fzg
zjm: man osg ysu rdk
bsm: wtd mgr
aww: kmr ngr wal lkx ial pfb uuv
cez: qpo dha eyq ffv mdd
msa: kkq nrh yri qky
jow: icd itx
tpn: zau veg
cbq: wmw jvu ckm wku gsx
uvx: twm pib ozu yhl aal quh dwv vyr
tup: mpv asp pxw
bcw: dbp zmq ysc fio wjl aib fej esp
sda: wml tjg pib wst svt
dxm: cjo rbo pjl
bgd: oxl hip eyl jml boh
xjn: bnn shg qzq szo ssn efp fpy xpf
vdw: gvv jkw zyr epl nol xqt ujw
fsm: auz pom soc ftp
fzs: tfl twm gfd wqw aed mbc
bzw: rkc
dcn: dbc mih tyr wnt nah
ckm: lor zbp
tjx: ict eut kkb ihk sqb nbz
khb: vwl yjk yki kpm asp tyb hbe ttt
kzs: yjb ynw czy rkg qxl fwm qky phn
fsq: ueg edv mku yks geg koe kwx hfo
yqc: koo mpv
nxz: jeo nhm bgd ppi lxh efc
oof: dwv tsx ktv qrd nxf afp vip cir
zqb: nwc gfd
axx: ybs vju iod esl
imx: tyb syo djd jmk yqb ozf dkh tgm
wnm: ele rho yll vbo
ewl: rsf dtp
dle: qny
ihs: ytk qsa uel qve
zvb: hhj ekh vsh
udg: tsy rrx nxo ceo qvv uuv
man: vip mvg nnm zjm acd vdh
fxm: wvg mbw fyr iet gjv
nol: mif yis voe ixp hsu tmv vdw xhl
rax: aed tbk acn vfb zru duq shh wbu mke ifh qij bcg
yxl: rgq bsc wbe boa lqf pho hia
ngr: qtl gnp pjo iav lfw
gzp: jpy kup efu sti udj ncn
alc: dlm bcg lkd ivw ksy qdi pte
sax: xrc puf crw xjg
pjo: ikr kch sdm
mvg: jxr snu qdi nuj yhl man uke
rdp: rbo wlz
cof: gke afp fsi qwp ear
syf: qpm tbc
cjo: ius bum qlw dxm yri ibg khv pmi
mke: peb sge lhz ztc
wjl: zjt mpa xaw ptz
oqu: glg onh ncn rcf mjt dal hfz
rqv: ffd rmg uyr wjd qlv gay
sri: kpm fly zro yoa mdu bri cbw onh
mdd: ozy azf
isj: nwj itx uwj vsv dqm arm lxh kkb
ufb: tkj hjx wdv bbj
rnc: duq zru
bdr: ggs
rkg: vnh aqn cjy rqh uyr zow
iiw: mxx ynv wfq kkf kbx
ngk: kzd git
ixp: hyk cjy
cjh: nuw mdf wib ywm qky dbe mfq
kpm: khb zro
cyx: uav pmj qpm odt
nep: svj rwm nsn qzu
nvz: vtl djd
qwp: pvo vmn
tmq: bpt ira xan nnm
ope: bmv ckc hyc zvc wbz fqj xbq tgt
hhj: bkq zvb vqz pyu sgr
ivb: xfw mqt
jqk: wlo wpo lxi wmw cvo
hip: itx lmv odv
pmj: cyx mgr zhr vgc adf
lip: flg lex pva
yxc: oho wem zua
ape: jdp agu mbp
tta: wnx tqf xxq
gxm: yhf usr aal msa smq rsj tsr
xan: tmq exf
ypm: rzt uwa rgm rio
enb: jol fhc lpt
odv: lsy hip rrt
vnn: egd bgd vih
lhz: uav ynw pje mke pav xhl twm
ucc: vkf epc uju
xtx: rdi ksf gtt jow
sdm: bnc zsi uob pjo yjm yvb
xfb: nbz doq lds jeo mep udj
esj: agu rew qvv ppp jig qbn
ijl: lex soc her
hae: gdr lyx
fnx: laa gjv
ogn: lvi jxr
jtc: mbx gsx syo pkp hrm bjy xbq skm dbp itx
vas: uke qny nuj owe
xhl: tpu xio ycx baq nol ubz bid qvd iop
wcc: pui yks
uta: ufr
xxq: fiv ozf psk ebx fjy vgo tta uya fbj frq gmz
dmw: eud jml qrv
jei: qqp elq
uya: xxq zyi fcm qje zau fzg lzk
nic: kkj xub dgf uic wmw ove
cir: tpu coc hvc zdl epc syf
usc: qvv yio diw kmr efb tkl byi tkb
ydy: amd zbp nxo qai
mfv: qru mdz bqo bnc dll hic qai qhv ljo
zmd: jpy
wps: nuo hcm
ydo: zxa wne
vxb: jpy jpr kjb ale pms esp
rdi: lpy xtx sti
cbw: hqy vsv enl kex
nka: bid cbz
iep: odt aqn ddn mft ioj pee
hmx: ela ekh esl kwm dnp jqv nll
hhd: tkj nka ttb
bop: rkc zau lmo
bip: ghy ujw pav myx bcx
ifj: fws qsu
wku: cbq yjm hem ceo
wbe: yri ifh
klw: wnz jen qvd
zro: jvu kpm voi
ilv: tyu ssr ntg
lrc: vyc rio zdn jjn
fzy: skn
bos: gvz ksf nto arm wal nxo
fqn: rwm teh
wfl: ctp hvg qlw mdd
qmk: ysx
syu: ueg jit xtx vwl
uwa: ohf
jit: hyc syu ire qjn tih ega eyl exl
mxq: oaa kkq uju tmv tvh
yks: wcc gxd fsq yoz
peb: osg tno uec pxh
qkx: her jxh rnr fjv
uxo: iyx fur ayt var
upt: ebx yjm
vgc: vyr rdp hvg wnz pmj aqn
feg: mcg adf rmg mxq gdb fzt jec sdo yll
sef: mcg yip quh ymf ayn ktv
azn: qhi clb bcg zwx
bei: rxs
ykb: kot mrn dbe
fpv: cdl gxd
fkp: pci gaq xhi
jrb: ekh dai khi yfj dal ckm zmt
ckj: jol zvc uhe qsq vtd bcw
lwh: ugl jmk
vfb: cgx qzq ern igs
tfl: hfx dni lex
ukc: sdo fbt ygi lte daj nlr ybv byk
qqp: vzs dpl
khv: pbh qjo
ulm: svj tno pho udy
lbs: uyx tqf vtp kke tma
ocg: wxp
bww: lki glp auz gux gac rwm nwc
tgt: mix ope
kcg: nbr hyh dai yzz scf
lvh: doq
may: qnt vsh zme zvc qvs xpi
mif: jqe tvh pbh nol aal tsr tjs gac
tkb: ckc qex ecu zdn
igs: ejh wml vfb ssn qzu owe
qrx: jed
kcb: szx hbe gtl gjv
ecu: ppi tkb jnv byi awx
rxs: dkf nlr bei nep flg
vyz: zzc qky tpu rho rnc azf
tno: nah czy
cfn: dlv jbf
pee: iep uke ioj gav oki hhu
xvy: efc vau hfo
ptz: zjt bwi hbe xbq yjk wjl syq udg ppn
clv: ggw yip hzu
mip: mms psk
kbu: fjy lpt pxs gaq ywl zpz
rtz: sfs
adf: feg mtx
wgj: hkw oaa mer wwe bsm fpy soc
slb: wnx yxc
hvc: xdv rho oxh pfv etk
zpq: jpp sfo
gay: rqv crf pxh pjl ruh hvg hyp
mci: tyb pxf lqj rhw azc cmp hjx
ear: ffd fsr qmk
xwl: efp buq pvp crg ffe srt fbh epc
pfe: vko djw dmj
vwl: khb ihs wpo fwv kch
saw: lpw
jmj: eiw qrt rgq swh syf imp
pjl: mcg gay sck xwz dgl dxm
baq: zma jzw ygi rmj
ssn: igs xjn
tnl: mfy ekn oki
lpt: kbu civ ove yfj
rqh: zvd ujw kps rkg wxx nxf
ekh: gqp jrb pnv usd rhw
ybs: wku nxo dff axx ikr pjn
qzu: hzs mqt
zsv: sfo znc
rsf: wwe cmd ghy rdp ewl oum
mlz: gke hsy cio nuj ufa aku xlp vcy
fjz: azk zif xvy fqj mbp omm aah
paj: rnt sdm uwa qrx qzm qxx
oho: yxc dxf hem vni
arm: omm isj yoz
hyp: gay qjo szo ywm
yyy: mmh wyi zmf oio
our: ire vau emr oyw esl
iuf: smq snd oyq hjx elz pho gif
rse: oly mpa fpl
aah: zdn pxo hyc fjz
woi: yhq
mfy: dxb tnl uma fsr myo zma jjz ykb
itx: kkj jow zec hip isj
oaa: khe ptw
inw: azf mft btj ejh oda
gsh: kqo voe hhu
pma: pkp rcu yio
uqe: kwm kpm wbz uym
qjc: ndy stx mqz rlj tgw
idi: zpz dmm xhi kjb sdm jxl azc
vmm: fkp mbj fbj fiv jow smu jml
djr: wsi pib hpu rqn
xfw: aal wif ivb dfy xyy cnz akg exf
rjt: uma tbk kzd fzt xwz kqo sze oki vij qlv git
mep: xfb
zkm: fqj qex sob mix rgm
iuo: kkq cit
kkj: mbj nic gtl hyh
jog: eud kbl yir efb ssi
zpz: koo cep fpv ytk kwg
rlj: qjc ear zeu vdh zxf
phn: auz fsi
yki: khb xaw qsq omk
lbk: ebm uro qjl tgm abe zcc ibt wcc kqv
cwf: uke vkf hsu rin vdh nwp ufk wqw
cam: rrl lvi fzs zqw fbh yis
aed: kzd pfe rax ftp bif
owe: elz gke odt
qex: zvx kfn gsj nvz
zxa: ydo
wlo: spr rqs uhe
hfz: agt onh esl kwg
uny: kup wbz gdk
xap: duq tpu ikq srt kta
xzu: mvu fbj uob mjr
djf: uyc iib oci rxy gwe lix wfr
oge: mbc jxr acn
fzt: wxp feg
tjg: sda ptw mys ifh ofl fgr
ifw: wem gvp mvu
drt: bev dkh byi fpl esl
ass: dxf syv lor
etk: tvd azf yvv bct lpw hvc ezt lyq mke fnc snd ilv
koe: fsq ial nfd
ozr: djw
kmr: jbf lld npp aww whk bdi usc
ehj: jkw umu uxp svt zhr
faq: jzw snd lug boa wxx dtp oxh
eut: qhv zua
yyw: ume ewo fpl
rcf: ppn imx iib mvu mgk yhq foy nfd
gwk: voi qsa hav
jml: bgd dmw
ruh: qrd xyy gay
glp: zhn ozh pry rbg
gut: oxl ial ohf rka
jlk: zdn cep gvp mdp ssi kqq pjn ouz vtd
cep: dbp zpz
mbx: awx jtc
nah: zeu exf rlj tno mft xte
qpm: bid lfr syf
ytb: flz pfb vgo hcb fdc ncn rgm ohf emt qjn ouz
bxz: mbv mue hfx ijl cyg
wwe: lki jzq
yoj: zlt wfr jdp hyf
xbb: zsi zcw pms mfe iet
hbe: ptz mzi
ume: zvr xpi zif ire yyw iww
zme: ray lyx may fia
jqe: mif jfk xoq
ylc: vfb skx eze isw
bno: psj zvc qvw
hht: dlm rin swh sxb
bss: jxh ggw qxe vfb ori msd yhl
txa: jkt hwz
skk: nyz sbh yri qtg rxs bif quo qxe
hcm: tsr wps ftb bnn sxb
itl: kfa uln vqz dyv
ybv: ufr rtz sck ngs sgu
oxl: njr eyl nsr uel iyx uft jed hcb gut bgd mpx
pjz: zqn gif dbe
gaa: gwp ixu cbz pvo klw
yvx: uya sti kbu uro vaq
ggs: arm bdr eut kpy guy
pbh: gux khv pom xte mih mif jpo
ewo: xvk oly qwl clx xub yyw mbx
ioj: ydv bct qdi pee iep yhl sib sze
mzh: zmt
idy: naa nrk ixr oci mpx vdz kcg hyc
amd: wpo ywl xbb ydy qzm gvz ziv ceo was
lmt: ssi mci xhc lwh zro
njq: aib lyf nhm
ftp: fsm wml
dqm: qtl ake gtv
uju: jim ucc
ove: qhv nic pxs
hkw: snd oge ddr xan crf
iod: dkh omk axx ljo yir ebx jwf
qkv: hqr ykb saw ozh
elz: sge pzt mdf owe
dnx: rsf msa rzp ujw qzu yis mbc
nyz: mzo ktv
qvd: kdk xhl pti dpl
wje: exf myu
tsr: baq xio vdf bsa zsu
fur: rdi tut uxo txa
qve: mdu
ryu: ghq kup mep axx
bev: jmk drt pnv kqq gdk
ljo: mfv mkw veg
dnp: rch xdb fpv rhw lds cbw
dxf: oho nhm ikr yim nvz ass axx exl koo
syo: fbq tom
wmw: jqk eie hae
tgj: lsy fqj kdt wal mjt psj lkx djd lkr egd
uyx: yot zog
aib: jol xbq syo fly njq
dgf: kqv vtd nic gtl zmd
dfy: fxs qmk byk xfw
usd: hwz kfa zcc
amv: ueg sjv edv vaq
ela: qsa fwv fia abs uas wpo hmx
was: yoa ruj yhq
vmh: odt zsu
wpo: jqk swb ifj gbv qnt rka vwl
tkq: ufr zkl jei gck dnj srt rdp rgq
ozu: mme lvi
yll: ffv mmh aqy emh wnm lxz
cwu: mms kdt
urw: puf kct hvg tkq wsi vry bkj tqj
aku: bpt elg ori
fgr: ofl tjg mme gqx
azc: mci ray
ttb: hhd kkq udy
uyc: doh njq
hok: jzq zqn hsf ojm
jvu: cbq lxi ifj dff eyl zro
ksv: waw hku jen clb
lfh: tmq yie ulf vfb ikq
rzw: pmi cyg oyo mum uqa pry yyr
cbz: dki sfo wps nka sqf
eie: dlv pmq
lof: xvk vgo eeb kzl ifj emy
rbg: vbo ozy oio
fnc: etk oky ymf ijn eoa
kle: hmf dhy pwj
vnh: dec qmk fdm waw lvi
hfx: tfl qkp ltv bxz
rnt: eva pci yoa
gqm: cmp uwp osq wlo
msd: bss xte mfp cqm qzu sfo
bqo: qsu mfv eey
mtx: big adf csy ddr hsy
glg: efn pki
wbu: cit dkf rax
pgl: ffv jyy rtz
jen: oio vbw jzq khv mdd klw ksv
vdh: ygi gvv
qxl: ifh sxv hhb
vbo: eyq syf zqw rbg dle ius wnm
fws: doq epd ifj gsj mfe sjv
mue: mfq woz wmx tdb
pap: qzm iwi pif gvp myp
srt: xap bgs tkq lfr
xze: tyu zqw
hsf: pje eaq hok ewl
zxf: bei mqz fsi gav oye rlj pho bgs
pni: uhe huw amd huz uas jrb hbe sqy
pmu: ssi iww joc ugz ppp uyc
ori: bss cly dgq sze
gac: dkf ltl
xwz: pjl rjt fxs kmt
rhw: fbq ekh
elb: fjk ihk fzy
zbp: fiv ckm
yri: wbe
lmk: smq tyr pib kct tzs
swb: ceo ltm wpo
qjo: lte afy
uav: oyo puf vzs lhz ear cyx
nnm: tmq
bnc: meh izg sdm
teh: fqn yhf
uel: pms
hxz: lki vte gog mft
