thv: jdn xdo mlf uwy
dlr: tqt
aep: pdi ran qwd dsh fnv
aat: uoi hmx mcv uhk
pom: cwb nrq yee zis
jgy: isw mlf acf
eib: pcm mth kar
xry: guh yva igs ccu yrr avp uvm tdt xal ixh
wwv: cba uqb ami pdp
ywf: cux
tzj: rsi gia qug nyb
tww: cxz zzb kub ecj ssz erq qkw aip spj xgj lvi
ayo: ddw
nki: voy lpn vci bed yjo
kgn: aaf yzh
aty: cun hbn
jmb: qog lvi hjn qvn rna
qjh: jpi yzb
bna: wya lai ufr
ckg: smw rio
dvn: kig yqq npl rvr tur cpc mtn xgd
xkm: xoc oid kcp rgu sso
soa: vas lob ugg lkp kzg
pak: fcd xkh itd hdl pmv adc sty
zzb: spj tww eqs rgy
hcx: drv drj kjt tyc
ccg: gpr ywf wsg
uwy: lfr xkj tkk
btl: peg ieu rgt wgm fei fxk vrt
djn: dsh ioy fsy saq aig psq pkj lne ijw tuc
bkx: kpb wwv
idf: ojg xtc saw ivk mee
pkv: cwx mto
blm: npp lsp khm mmb
tfm: rgr
clr: tvm
vbi: hey wga uad vti yzc
nzy: oly vgt trj zfo oyk
jmq: peg ssd zay
rtv: qln zrn meu hwy zzb
gia: mwm tzj dxw
uwd: jcb gmg czf btl jlx scw xpb rdh tvx txf
ddw: kts fge cwb ayo mkv gep mvf
vci: hlf iim nki cwy vae kwz vdt
mkr: drv iwp
czs: fwl czf pus ftq prz kyc edc dcn
ugg: nyb soa you man ybu dfj aiz bwv gcb
jry: hum yjq wgz kct
yww: rzl eib
fhh: uqb zme edc zch
wbh: zxv tkg kka gth cpu kxj aat
sdb: cof sta sax mow pju
wga: dui dmw
kvz: sik oex icv
ykt: jcv vfg skb frr
rkq: zjh rbq par oja ymc
oiz: cxx svd tos kms wji fyc
udi: wqi zyb
drv: gxf mkr ifi blx enq tja mar hcx fei cez icy
mha: bky upp yds mjy
gdo: prz
inm: qah pnr ggc xmx
uhk: ira szr thh yhh
ufn: ouj zme ztv rjq lzq tdv pnd lsp
tpw: jmo ccu hqh ann cvl vmg lhd
bmt: tuq nej
hry: rdk jdv toy
tdr: ahm xqf bay ojf fkq bnv
vbp: nyb usa
cvr: hne npb vhr pif
tmo: bpy cub jwu
stm: djh scw qpm vjj
goe: jor yes lqe iom gdq
mtt: zyb pnr izn usx
gjj: pog jnz
qjv: ihm
hul: uxq eib rik
ekt: tur uan euw nlx wko gtq
aip: hjn meu ira
aqc: kts gfy omo fau ibk pog
you: bpy qrt ahb bid rwi wyb
fgv: ura toe zbe mcv nyf oqa mow
jmo: tpw avm
grz: ywy pat iek owp izg cub pim qdy yeo
wjn: gaz ssz wvu rgx
bkg: qvn utf whz qdz ahb jor see
zgi: zfm zqk
ode: ewi ran tuc
rwu: ald iek
ghd: pwt rge xfj wgm
zat: zxv dhy olk
ofb: vij rli boj llv ahm
blx: rzl
wui: vfb lrt ill nem ppd cwg raa oja lyx
ohy: rzl poc
lqv: eur use
zmi: dvq uyi utf ekl bog nbw uih
gth: wbh rvr uad
vrw: fbd kub rvr acf rsx lpl
jon: wla dei clr dvt jor dvl tsh
ckt: ups spt
mje: qwd rjq gph hov ogc ieu
ctg: wvx bwz qvj
jvb: abo scz tpr rpf szr
bbc: gtq oic
jcb: wgp wao mkv
zsu: knk sud acj tpt dya vqy bnv
dcu: rjq uwb bmr
zrn: dif igp
qcz: toe pnb dcg tux gfk rbt kje kgn ekl lkp
akt: uuw iyx iek ubj cdm tie onf
dmt: spt akt fcb tgo rvr
xkh: ydc gph fmx pak waz
zpd: zpy dcn xsk
qhf: ldj vij toe zbl
qpm: tke
cso: rhv rxq iom rli
gru: blq nbr rek
egh: sjr tor iqa lkp zah
ras: jln
ulb: vhr tpt lqz mwm giw
ict: uhh vkg aiu fhf ncs kcg nlj rxq obn
adc: rbs pan aon
ntc: lth bzd sxe kmz dvd lzi tsh
uwb: anh oop wmr sso fcd poc dcu
mcv: nej sxt uih ubu gkt pef
ghm: gjf nlj udg
zhz: yhl mkm hqh cpv
jsc: yer shz yjo kaw
vbh: dim
big: ntu byt eni kid fnp rzl tzb tes ifg guh bwx
eqs: nqv kka cub mwm
lbp: noi sqx
mfu: tkg xnx nef uuw
wic: tdt hnf
tiu: cun kwo ohd yxi dtp oam tyc ejh oje
sty: qvj pak drj npp
mfo: nxd hwy rgr jcm ynf
gfi: fmx pwt xzl
zwo: yey ksi fgx wak ylz riy
eny: oop yva ayi wni spw
avm: idw wsk jmo
vti: gnq vbi exo llx
use: bvo lqv agg
kee: npl gul kmf rug gnq
tdy: spm dvz euw lbh epy frj rgx
day: rps hwo prd
sxt: ejz rbt enx njd mcv
eyh: mbc izl hwy klp vbp uoj zbl zrn
qcx: lvi pky qun lpl ljf nlj ndz
irs: tmx wqs
taw: uyi xgd jws lpn
tie: ali jti pju ecj
glq: qxf xhs sgn qug ofb nfm owp
bys: fdg
ads: icy egv gjq kln
csp: cvo qvn ljf axq cvr qvv kfl
fau: sfx ekv aqc
ggn: gcb rwi
uwc: tuc bky
yjg: kgc ewi plk hoz
qvj: sty kgc
lsp: bfo dcb cfx ydy hnf blm yrj xbm
fnt: jqv gsv rsw xhf
cdq: ftc ydc twe
jxs: psx ras vmi
zis: dcn mdd fvt pom ibk
tjq: npp bib pti rww
bfb: pdy cib moe
onf: rwx ywh rli
xvi: cvo rgx mga fbd axx duk qjp heb jre knd
uxd: iyl aty cee kcd xgv hwn fir jnz
jqz: gps iey gmq
ema: fgm tfm uhv dui rtw
gsw: xwt agg ode byt pji ihb lzq bfo
jru: tlf ita axq wga wla iqa
nlw: rhu zzv wsk
yqq: rub xgd dvn
frj: tdy kms
pxo: jqp rgt ken nte nlw
zfm: yxi zut vxq zgi wpu hkb
uxo: amc why nol kwr
vby: bbb abo njd alp
rgu: bfo
inb: pkj gdr ckg jme mdd lyx
nxq: jme pmr tid azj wqk itd rbq hqp rcn dvg tjs
xnb: qno dei rgy lpn hmx
ydz: sax xsr utf uec
uce: wtz ifq nte
rya: lnn oly
kov: hie abo lsw
waw: fcr bhl tpt yre jwf
lki: rdh qon zkl skk vbc dtn ifq ifg
dxw: gtq
fyc: gtv una yur
tkg: ttx mfu ipt
agg: use hch tnu
pdy: yxl lnn dag rwi bfb xlf
puu: vbp hsn kaq tux gfk
suw: lfd cvo nyf fxp zfo
gdr: dnu rzl nbr anc rgu
mkt: sta ykw klp dhy
lxm: mmf dif lai llx
owm: oam usx fjf uah zkl fnr rge kxt dfr
dfw: rcp cub dvq sjr
rtm: yxi tsq bwg
pji: vmi xbm gru pxp gsw zmc
cun: ine vsn tiu dem aty iwh
xqf: hmx lvi dvl
tzk: sjr ijo tux htm hlf llx mfo wsg
hiy: heb bsr
sqd: ymw tnu cjs jos rdk
tle: xri iai rzl fqd
ojd: dij qns
gps: rix jdv jqz bkx zgi
gne: zah gtq xhq
nte: pxo
hne: hwy kax amc poo lkp lod cvr uuw fyc hsb
mmv: rsl cxx pqq
yds: dij cnq rcn mha srf xrr pdq hoz
qha: dcc saw mrz xxl aon nbm yot
usa: enx stz
nsq: isw flb ofi meu dvz
hsb: qrt aiz
uze: tsf yfr szr dsv qrt
enx: hrg usa ysw vri
ysw: duk bhu yzc
vfb: wsk pdc oja fej
gqu: shg jym zpy jlx fqn
ztv: lpk tbf qip ijw vbk pse
tur: nmq ekt ctv loa vwz ylz slg mwd xqf jsc
ubj: vrn dod mxc fsb irs
bhl: bfb pym uan uwy waw
vaf: aqz zzv coe fej xoc
mvf: pan ddw oir gvw bfo
bmh: umo fta wog psf xbm owc
jkz: fyl uwa waz
air: yfr jtq jkc
klp: qno sax mkt
vwk: coe gmq ghd jwx uxh nir pus mjy
wks: bmt dvt ggn mrg
vwl: dvz idy ltv rhv
vbk: pti hov
ewq: ioh iof ojd icv
zcc: khm sce hqc
dqq: gai jar kcp pdc
dkj: dsr nir bvb nnt dtn dsh
tvv: egh eov fhf pat gaz bgx
jfz: wht qey rek rix tcn
zvc: vxw bib oop wip cmv
ywy: uxo rub una cxz grz kwi csp
gjq: pdp
eko: dly psc lpl fkq bst
mow: wup fgv zez nyf tgi
prd: ffj avx gqb day yxl
fii: tnz ngs ylh sze
fnr: kjt wip oja
xjy: zrn rwu yes ffj uan imy orl
abo: iom kov vby
jln: tjs dtq ixh fhh ras
shx: okp yqq ltj
mto: nqv orc uec mnt pkv
lyt: xtc amg ppi neg pdq huf cau vhw uvm
lpl: qcx ysw
xuh: vie qhx wao rjq ads
pse: oqu lne xdf pzs drj itq
zay: ydc ngf
trn: kcp sye vsn lee zlj fvi skz
nes: kxt bqm wtz vxw cfx fua
gdg: hqc kgc xmx
lth: mlf ntc day gne hko orl gzb rfa uhv
vkg: gaz xzu igp yhu ecj ovb zfo
rpq: hlr zrq
mls: dsh wno bmr xpb
ubg: gfk boj qvb
hlx: jym mqu ixh axe
njd: vby dvz zbl
qeo: mmf owp
cfg: zbh xrr pcm hdl zby
ojg: ltr idf oop tnc fmz qmt uah
uec: ltv mto jpi
aiz: hsb waw ahu alp stz
wog: bmh hov xrr noi
oqu: ltr
xzl: gfi
mjy: yot kdb nbr ras
pti: raa vbk pon tjq
mwd: tur qsc fzb hjw dhy bay
itx: ioy huf tke
pef: man meu yhu cgn fgf vbh okp
can: lpb poq fir zyn xrr xtc yrr
esm: diz fau nic xuh hlx ios jlr eln lrt
lod: hbb hne jms izl pky ngw
rep: umv
wrv: idy uxz
plk: bds sze ydy jar yjg
kfr: bgj hjw jti uoj
seu: ymu zby oop sih yiw
jpq: mjl fzv
jar: vxw kyc ccu edd dqq seu bkm gdg twe yvt sty plk
toc: xbm peg
dtp: xxl dlt klk ufs gxf wpk vmi byt xwt
pdq: egq gus fjf lyt bok owz
yry: fyc hax pif jtq
yxs: neg luu
ohf: qon rgt
ego: qze qkc
noe: uwa rhu dcu tdt
myi: iel dod
qqj: gra shu mvi
gaf: iey eus
lpb: pdp fcd cot
flo: xbj hko rbt jmx
cnq: jgh yds ruc nem gvw
mim: fic pdp
lfr: qet pky uwy
rps: tii mkt lsn npw qno day
bid: ups rpf uec
srf: exp yww
nlx: ekt uux
jym: yqc zdb cmv rbs khm gqu pne fnp hlx
srp: hum vqy tim
hzz: ifg wgp bwg aep
egq: etp gjc umo qmt pdq xmx
rdh: oru uwd sye grn noe xkg lki zhw ngf
jdv: bkx iab gdg fta gps uob nlw hry
zwf: che dfj oic tuy
yzz: ccd yre
oam: hkb bmr xgi twe tiu
mtn: izl ofi nyb gaq
amc: ljf
wug: gmx wht bts kcr ifg omo
hrg: sww enx yur
fmx: gfi tnu ufs stx xkh fqn
vmg: twe
vgt: odk qug fzv bed nzy
dcg: eoj ptz
cvo: suw alp iit
idw: kwp fnp
rli: cso ofb ptz
xkg: pcm kpb tid
jtq: acf wrv air
ymj: nlj luf dvt ekt mmf cpu orc
hax: nqf
orl: heb wfx zah djb ypj
qnw: fxp urr mto
qmt: ojg yed pdc ddw ftc dtn wmr yva
yvt: iwh lii drj xsk nbr
vmi: rtm jxs twe qoe
oic: yre duk hie ndz zwf
skb: ykt yiw nbr ibk uks
iuc: sqx esm poc chu bib kar pnr ohy
twe: zxp cdq vmi vmg wim
mlf: thv vqy rti iit
jqa: pju zbe qmv czi iyo
cvl: fps oms pnr rxr sik xgv icw cee
umq: gmx gfy seu
mrz: fzh
qns: ojd inb par ymc tke gaf
zej: pnb udg ogn gaz rti wya
xtx: toy dtq jos kpn jxs
ejq: djb rgx ozr ppb qjh
umo: egq
kfl: ydw axa csp klf ycd xzu zll
imb: jqv fsb
kts: dwl ddw
gmg: bcq diz nlm txf pus aut amg kwp
ioh: ewq ekv dlt tnz ohi
jos: sqd itx xtx klc ran kib jzm vbk pom
uga: lyx fzd frr azc upp fic gep pnr ayo cjm zpp
ial: ydw iek ffp
egv: jnz hch
pju: pcl akz sdb
qvv: pky
ijo: wsg woc
mwm: ttu eqs bna
zqk: oeq mwg zgi klk
ltr: eln ojg gmq cjb oqu
fcr: tru waw
xhq: ksi oyk
jzz: xrk kwr tma lnn
kxj: vad cnv moe wbh
dui: cif knk wga ema jwu
tuc: ffi alx swz ode gjc uwc
gmq: vwk
mkx: qog yqq wji yoh ylz bsr
omo: bhy wug toy ill
pnd: anh qey tes ufn
dsh: mls dkj
jbj: oms bkm kyc ipx coe scw gvw hbn nrq
uih: mcv
adm: zzb wjm
msy: wqv czf bqm fgl jxp sfx
ppb: zap ejq jph skr gbf akz hjn
ynx: rsw aaf tmo cvo gtv qtv ufj fuy gtf rgr mvg
bvq: amc dfj
yee: pyx fzd pom
orc: fda
qun: yet rsw
gqb: bsr wqs gpr knd
jqp: ngf yed pep pan pxo wic swp
dcn: vhw rdk khx zpd czs
ekl: rsi qcz yzz
pyu: lgx dhz rge gys
zxv: ywy qvb ocw zat dvz dlr pib wbh kaw hsn yif xhq
hqp: mrz ihk cau isy nrq
gki: xbj wqs svd
ogc: njo mje
cez: fmz ook
xoc: xkm vaf
fge: ddw xmx vqg jlx dcc
wgp: ihm znf jcb hzz jkz ruc omo dib
iom: ejz qkc abo vwz
pee: tbf szk
weq: mwm kmz zwf dlj aiu
wla: mxc rtw kfr elk jru jon
yrr: zme can xry mee ppl kln
ojf: vyw ejq kka tdr cib rtv ubu
boj: ptz uyi
upp: ewi oop ivk fjr jdv bfo bvb ccu saq hoz mha
ihk: gra nfi jlx
mdd: oru dvg nbm
oop: seu uwb eny
jwx: vwk pon owc szk fua pwt gys
qze: ahm jgy ego mwm ijo rub hwo
jgh: yog exp rio
fgm: fsb lzi ema fkq tsl
vwh: jtq vyw ali uih wup noz
jmx: xdo
vjj: bok hpt xdf qah
rhu: saw nlw
qku: bqm
wmr: xqb ipx
wsy: mbx fgf udg qax obr lvi dkq
urr: ali yey qnw
huf: lyt vld auu
cfx: ibk nus pjm djh
cau: lyt dlt gmq
ywh: whz
oid: dfr qmp ran kyc zpd pdi
yrj: tdt sqx wno lsp
eos: klp dag tya tvj sta umv mnt
pkj: egv inb rtx qcp ngf
nuq: eoj mzi toe qln zez iyo nmq flb
gkt: lpn ufj uoi jmx zrn
tls: ydc smw chu uob sri qha
trj: fuy uze akz zcj
mnt: cxx kax mto gvk oyd ffp
aiu: tos dvq
qbj: xcy amg tck icv qak
ndz: fxd bvq mxd iqa oic
ogn: fzb zej nsq wrs khl cib nxd
gtv: ynx vwz nao
khx: ami
cee: hwn alx dye vjv cvl
zut: kjt ohd lyw iey vxw zfm hnj yua itq
ieu: fuf gfy pxp zby
mxd: fzv qjh vrn
lyx: cjb inb bts
gra: gvw ihk fir ccu qqj cez bmh
qlz: gbf rxq mah uld
mry: vsn cau jnz cev
pqq: npl
bwg: qrk lne hch rtm
cnv: isw kte
ffi: cma xzh
yzc: ysw fcb vit ccg qmj wgz
tdv: ufn guh khx
wqv: ufs luq coy msy
dfj: lpl zwf tkk shx bvq dlp
wqk: zvc azj lpb nxq zis avp dem xut zpp wgm
hov: bts rzl vbk
jme: gph htz tcn
itq: fua bwi uqb
hnt: pab ufr spt fyy dvq lhe
ftl: anc edd wim saw uah
eie: klc wno bqm
xgj: xdo tww yrl dif elk
qkw: zez exo cbu
utg: pwt noi umo
wjm: qmb wjf
tye: hvh mkr skk cls cyr ivk
tlf: fda zhd
ovb: iit
ezy: skk tke sty cot
zxp: pmr dck twe itd
qab: fqn npp mim
ymg: iim kaq
eus: add gaf izn fvt
zap: iho yjq
whz: spj qkc ywh ccd lsn pky
kcp: dqq xkm
vit: yzc sqg
ekv: ioh fau
kwp: wog idw ouj mbf ogc
lyw: pan hqh zut dza
ftq: xoc fir lgx czs
ngs: hqp uxq fnv zpy fii ioh jkz yhl
dib: ppd uuf cck hqc kln
wgq: qmp iof
zpi: jfa hem qwd
wni: pmv edc pee eny
pim: meu xrk rsi zzb ndu
flb: vhr ndu nuq kje abo dif
lqz: yzc tpr jpq rdq kwu ofi
duo: etg mkm
qcp: fsy spw
lvi: qcx jwu xqf
pep: hzz cot yiw xzl jqp hxp wff
kmf: kee sxe vwz pfb
lbf: upp tja znf
cls: nic tye wff inm
psw: cma jly npn ymu isi hlx pne
ufs: wqv fmx pnr iwp
avp: oir ufs vaf
tuy: yoh jwu slg zwf
khi: frr rtx
ims: zmc yrj mbf
spm: qjp uxz tdy
wax: dui ypj
saq: upp bts
yif: zxv uyb bay
cpv: gwq hvh sye ioo xkg
raa: pti aty ami xmx ken noi
qdy: qdz ydz dvt zbl tor
ill: sso qwd wui omo
exp: xcy gfy ggc ffi srf dlt jgh ftl
lzi: rpq mbc wya fgm pfb pab wla
tor: qdy ptz hmx swr yur
cwg: zme saq ewi add
oms: xcy czf jbj ymw
ffp: dod
tmx: swr irs frj kzg
ula: zev lqz qog bvq rep
axe: idw hbn exs mee dsr hlx
mzj: wsk sqd cev wff hem
mbx: qjo wsy bgj evi qog
yxl: stq ghw qmb
vqg: znf xut fge wtz fjr amv rge
gus: xri kyc
ylz: ocw zwo ule frj mkx tur
isy: rql yot kts ggc tsq
ine: chu rek saw wef vpg cun ymu vuk bvb smw blq ami rzl
uan: bhl dif xjy eku
wfx: axq orl
vhr: iim bfg dod uih rti cvr zcj yhu ycd ulb flb
yay: nao fnt zez
iek: gsv uad ial dif rwu xif
dmo: noe ghd zmc smv fjf kar eur ppl
thh: mkw cxu uhk nxd wax
nfi: msy cev zpp hpt ihk wug oeq pln
rik: shu
yhu: rli obr wsg pef
erp: pnd gaf zqk xzh
sjr: jgy iel egh ovb bst dfw pab qtv ucw yre tzk
fcd: xpb
ity: sax ltv htx ura
dwl: zbh noi kts
axq: ynf uuw
wwe: kdu tsq
ggc: dij ohd inm
hdl: vdq cfg pak cnq ohf
jph: ppb xzu tgo tvm ufr
gxh: dwl qip lzq gcm rhu zbw yqc
qjo: mvg heb izg zfo lhe ekt urr dly bwv mbx cso
icy: drv klc ads
xri: zlj hbp tle uuf vie utg gus
ydy: eie rev lsp avp
xsr: axx
get: owz psq vuk
scw: jbj klk dza jmo stm skk jlr los khk
tvm: akz clr elk
mar: qey
icv: izc hbp kvz
sik: cvl kvz
gul: rwx kee
sri: ukc duo yhl tls lhg hkb ios ohf
rbq: izc
iit: ydw ovb cvo ywf
wwm: hjn tpr
wqs: gki gqb ozg
dif: flb zrn vdt uan
oja: etp rkq
awu: kdb nnt npp tid plk mwg
xhs: ycd iyx glq qsc lsn
gaq: ore mtn odk cdm
klc: nlw kib eie fta hnf jos ill icy mqu
qog: gki ijo sqg mbx mkx jmb ucw
noa: acj npw
pdc: qmt vfb
yet: nef oyk jwb kwi bed hiy qun
tvx: iyl uwd qux ios
jnz: uxd mry uxh
fgf: eoj zrn
ybg: psc
xkj: mzu uwy
wvu: uym
axa: rsx pdy cjo hey sxe
wji: mkx viz
kpn: bok xtx hxp hbp par gqy fwl
kwu: ltj
gdq: bnv jcm zat ccd goe vhg
zbe: flo fgv gsv ylm jqa
wsb: etr gph xkm enr kts gmg
zif: lhl moe wkf qkc
qyr: tnz sqd hem ppd ann
pcm: vjv xkg eib uqb
vhg: wyb qet aaf cib ftk gdq
ipt: zll jti
gpr: zif ccg tii cxz gqb
cjb: zbh sih gdg lyx ltr
bed: ylm nki yet ull
qmp: wgq nic oid
jly: wtz lhg jsr psw zhw wwv los nus rgu
noz: nmq dvq dxw
etp: ifi njj oru jmd cba dsr oja
hmx: uoj
oje: fcd ohi pog
vae: llv sud eka qij
kzg: rna tmx ogu vbh
qmj: qcz sxt fvu yzc akz gbv viz
sfq: xxg qnw dmw tlf ufr iek pxq kje
yjq: wjh zap eko jry tgo tos yzb kfr
ofz: rub isw ywh
vnb: llv knk zmi cxu vad erq yhu wak
fzd: aso xzl yee ukc
stz: xdo cwy usa uan iho ofb vva nhy
ijw: djn
pym: wjf duk
hey: ndn vbi axa mxc ecj ovm ldj
zcj: uoj vhr
dij: nem zhw ojd iyl rcq ggc
pon: pti dcc toy
prz: cev gdo yiw zpd
jwf: qkc dmw gzb mvj mfu kwu waw tii
iyk: edc tja fjr fic
mkm: zhz duo hkb gxo tid
ore: axx
fdy: peg wqi oeq
neg: njo bwz yxs zlf xkg
aut: gmg nyk kgc
xbj: hyt flo jor cxz gki
mah: rsw ynf
iey: ken jqz gaf kuj
rhv: cso gqb mvg pmk
add: eus
gbc: hbq qah ruc cjm
vrt: btl mtt xzh poq uuf kvz lqv frr
shz: dlj
zbh: coy cjs cfg dwl oeq bkm usx ggc idw
ccu: upp jar pnl gra
ake: jfa ftc inm coy hch
euc: khl vij qoc rub iqa gth
tsl: uux rpf rni tvj wrs kms fgm
fkq: gaz fgm eko hrg
wsg: knd iho ijo yhu xgd ccg izg
izc: jmq ivf kpb icv cun oru chu rbq
ozj: uhk pfb zyy kxj lkg
vuk: cau vie pom zxp jqz ine get
gaz: vkg
wzz: mmb smv qah qmt auu ioo
cdm: lqe iyl akt lnn ozr zyy gaq
iyx: moe
njj: dtn zpi tyc wmr poc zch
qmb: wjm ttu nhy yxl vbp ffp xnx
rxq: qlz ups
klk: dtp khk
sxe: akt kmf ptz sud jdg irc
eov: uym ptz
gnq: vti fda zbe kee
yey: wko jqv zwo urr tdy jdg
dvt: qdy jon qrt
gph: wsb mje
lai: bna lxm
uxz: zev cbu spm wrv
rwx: onf jmb uze khl luf czi gul ccg noz
bky: hqc udi mha fii
ejh: uxq
ksi: umv
vpg: ine qjv
stq: ncs zah obn rcp wfx yeo nyk yxl rni
xfj: ghd bkm lpk zis
bkm: zpp xfj pxp ykt
fua: par cma ckg jwx itq etr
kaq: ymg gcg
xmx: gdg inm
tvi: spw qmp bky hwn tvx mee fps
hkb: mkm oam zfm
isw: imy nmq jgy ofz nsq cnv ctv
nqf: rit hax jkc nki imz iom kxj czi ywy gki
oqa: fgv kaq hjw zat
erq: vnb sax ltv gtv ttu oyd
skz: sxz bvo lrt pgq
ngw: nmq rgs gcg axq lod ywh rug
svd: mvg spt gki bbc xxg ity oiz
guh: yxi xry tdv
anh: dce uwb pyu mwg cqd khk pnd
etg: ymc duo ezy nct xqb cee
waz: xkh jkz ohi anc
fej: ctg
wao: xmx whh pan dsr jcb iai xuh zdb
sud: zsu
nej: bmt bsr
mvg: qjo svd
qvb: rcp
ssd: jmq kib
ogu: rpf
hnf: xsk wic uuf yvt
bgj: umv kfr psc
fxk: etr xia btl
hbq: raa zbw prz shu dsr zpi cfx ims
kje: flb qdz ore jkc qcz
bsr: nfm mkx
uad: qmv gth puu iek rvr vbi lmm htx wyb
lnp: ybu pmk ayp okp klf kcg luf kct
khb: tdv zjh mar kln
tja: sfx drv
nyb: ggz tzj wqs vbp kiw mtn wrv
pzs: pse hul toc
wgm: shg wqk ghd
dem: mkv nem cun
owp: sud grz ccd acj qeo
cif: rsl evi
xhf: fgv fnt euc vad gia yrl xnb tqt
vie: xuh auj yqc
uoi: gkt yxl gzb fpz sit aat ofz rgs qmv ljf
fnv: jxp nyk aep ppd kvz aig itd
mjl: iis tsh rsx kcg jpq umv nqv bpy
ruc: frr yww fwl wno
qak: wvx qbj iai
xgv: ihb icy uuf
kyc: jbj gus poc oid
psf: mth bmh
ups: rxq fxd qvv ckt
tsq: rtm wwe
oyd: oyk nxd fbj uxz pmk swr vtm
iel: bwv bnv dsv myi pif sjr
ctv: tur iit fxd zyy
hnj: fyl wpk
nsn: yer jpq ltv
poo: rsl ald kgn yzh
kcg: lnp ict bog xnx
yer: eku fgv qdz vic ufj jsc dkq nsn sgn
lfd: skr obn ltv noa
dtq: jln jzm
giw: rug cvr qeo
aon: qha uqb oex adc
jbb: cpu
kar: dmo xxl eib gcm hxp iuc wip swz
dck: qjd gmx
vxq: hkb tvx zfm jmd ctg xrr cjm
zpp: uga guh utg
gjc: tuc egq
hpt: tke ppl
bvo: skz use frr ppi
fsy: djn kgc qcp gyj dza lbp dib
fmz: qoe fmx cez zme jzm
gsr: ibk nem ihb wpk
nem: wui gsr
lgy: zpy ojd pmr xsk
swz: kar tuc mim yog djh
eur: xrr ifi dmo lqv nrq qqj qrk qku sfx
rcn: yds anc bqm nxq
nlm: uvm
ukc: zjh oeq sih
cba: enr qvj wwv uks
jlx: fge gqu tdt qjv ihk uwd
szr: uhk xhn
lhl: tya fbj zif hjn wax kcg
zby: zlj ieu
kub: shx vrw xkj pkv umv yif hax
jms: cpc rxq lod nef mbc dag kwz uoi
oex: kvz anc htz
nxd: qjh
nct: pgl add vjj bhy amg avm etg
oru: mdd rdh frr mtt
jqv: yey tfm djb imb fnt xlf
wup: jmx mow vwh dei
kiw: nyb dvn uwy ccd tlf ckt ggz nol
ifg: wug big owz yjg lki ake get sik use
cjs: zpd sqd tcn pgq zbh bwz ayi
ouj: ufn nlm fvi
fqn: qab fmx xzh zdb
sqg: qog amc yrl klf vit
jcv: dcb ykt iwh czs agg ann rge zis vuk bys
ihb: gsr tja xgv vjv
ykr: skn hbn byt ntu eie zay
ivf: izc bwg uce
meu: pim bfg nhy aip why rtv nao pab
gys: ppl gjq jwx swp ken kuj sri pyu dcn
kwo: eef sik
wpu: tmm rtx
lne: pse
pln: nfi cij cck znf qvj wvx
obm: ylh xkh nnt yee dqq
mxu: tes ifq jbj gjc wzz qcp aso
bds: sby sxz gwq yxi
fbj: lhl xsr oyd
rgx: ejq iom wjn xvi cbu zrq
ftc: gus cdq txf sce isi mls
bnq: zhd exo fgm fbj nhy
qrk: nhu bwg xal nir mqu kts
nuw: cim nmq job qsc man
sap: dlr vbi pxq pky sas dly odg
kdu: sik wwe jsr pxp bwz alx mjy
kid: cdq pxp wef big
fzh: wim ekv mrz srf
zpy: usx lgy ngs zpd
rtx: cma khi gwq
nyf: pcl kax mow
hbb: lod odk zat gbv vva wrs
ald: ovm rwu enx sax
rjq: rxr nrq mje umo tle mry dcu
fwl: kcr
pcl: dya ovb pju ldj fxp nyf
fdg: bys icw ufs poq
qno: rps fcr klp xnb
nhy: imb ahm stz qmb
spw: eln gsm pdi eny qcp
imz: job fda rps rni lsw
cgn: dei bfg flb
rix: jfz axe gps xpb kll iab khk oqu
mkw: bid zwf pqq vad nzy thh
uks: cba
nrq: jbj
fyl: ppd bys jkz wog hnj
smv: dtq vna
exo: bnq
qon: gqy ohf igs kln qpm
tid: frr
vfg: ykt
htz: oex kxt iyk
jwb: acj pfb eqy qln htm mnt
fgl: lii skk wxe
jdn: thv evi
shg: sun vfg
ozg: tqt
sso: xkm sqx mje ill
znf: ekv vqg skn uuf wef pln
zah: uyb stq nef gne
lhe: hcc hnt
zev: lsw dlj
mym: igp rli jbb evi hum llx
bwx: big dcc neg zbw vxw
ssz: ltv tww zll
ebh: szk tzb wvx hkb nes ohy skk qwd sby
wko: htm tlf yey ekt ndu ufr
luq: ihb tid kll pdp skn kib
tck: cot nnt swp qbj rio aig cjs dce wxe
una: kwi ema ydz okp ftk ywy cgn fyc mbx
xzu: jph cvr rgs
ftk: una pkv ali zbe
pat: grz hwo knk
ken: pxo raa nte diz iey
pnr: ufs inm
bfo: rgu upp oap
qtv: ynx sjr ahb mzu fcb
aig: alx tck
yes: xjy goe fxd
bfg: vbi euw ynf idy meu klf cgn
sze: zmc plk
rbs: adc qpm czf jym qab pzs qbj wgp
cib: eku bfb
ynf: tii mah
fir: xlp
aso: tsq mvi fhh auu fzd mxu
nus: fuf jly rww nhu
bib: wpu tjq wgq qoe
pky: lfr whz bfb htx qvv
hlf: vhy shz tzk lsw
sxb: ydz vri bna sax ura ghw lob uxz tpt
tes: mxu zlx lne pnd
lsw: adm vad zev hlf wjm kov
lkp: qcz
xqb: wmr vfg gfy sik pjm
stx: kll poc fmx kcd psq
fuf: nus
auj: ivk vie fsy lhd yiw qux
lfc: nbw yoh qjp fyy duk
loa: zfo fzv
nir: vwk dkj xgi
iim: vci ymg
nbm: nlw mdd pan zlx rdk
pfb: qax rsl
lsn: rps hlf xhs
pne: gsm szh lne zch jym htz kts psw pwt jlr
nmq: ngw tur noz hbb isw loa clr ita
xcy: oms qbj xoc exp
lii: pmr fgl pgq jxp kdb
kjt: uwc kcd ccu pdq hcx qhx fnr zut
mkv: rhu pan ssd ddw jcb
ecj: tie sit
moe: zif yif iyx bfb htx wvu
eoj: fgf dcg nsn iyo lob nuq
ayi: wht zjh
hjn: lhl jmb aip wwm kmz
wyb: vhg zrq pqq
lgx: pyu fvi noi
gcm: gxh zgi
oir: pau qxs mbf djh mvf
ucw: gcg cnv flo ckt
bgx: ita srp tgo nej cvo ydw
gfk: puu rtw jti ial vwl ubg
iis: mwd pkr ula tii irc mjl lpl epy xlf
nfm: bsr vva
oap: shu
jws: kig taw
gzb: rug lth dlj ubu jwf nfm uoi
gbf: kax ppb hlf htx qlz gth htm stz
nol: kiw uxo
kaw: hko lqe qjp uuw jsc vgt
mrg: mvj noz tkg bhu ykw
nnt: tck pau dkj
ybu: ugg gvk jwf ckt cgn
hbn: ykr aty lpk kgc
vwz: kwz gtv
rug: giw gzb ngw sas
cxx: qij
aqz: fmx vaf xgi xzl
pjm: xqb vfg
wsk: avm nlw rww
eka: tgi
los: kib chu scw
wjh: yjq kax gcg qmj sap
cck: dfr dib
bst: imy eko sjr
fxp: pcl zkx kwu qnw
kwz: kwi fuy pcl vae vwz
itd: fnv
yre: cim waw oic kte yzz
mvi: aso bmr tjs
grn: amv rxr hdl
dlj: ezw zev uec ufr dxw shz
etr: wsb yee fxk hnj
tmm: ykt wpu avm xbm xal
rwy: onf cux vad jcm skr rfa
ptz: rli sxe boj
kig: acj dvn jws kwr ayp xif qdy tim
viz: day bpy wfx wji akz axa jdn yfr riy vva
wef: fzh fvi kid ayo znf
kwr: pib
dvl: cxu jon jlm
fjq: oap gep cjs jmq mjy wgq jln zlx
uuw: axq kaw hne akt
azj: pdp wqk vpg gjq
diz: eni
pif: ksi pxq cvr yry tax iel vwh
qoc: ymg fbd wrv mrg wax euc
ipx: czf wmr owc qux txf hpt
xpb: fzh fcd azj gjc umq rix qap mls
pxp: bkm kdu pji
aza: itx uah yxs tnu gxf anc lrt
tim: fuy eko uld srp tmo
fvt: zis eus qjv
epy: tdy kmf hcc cux sta
gtq: ekt jon dxw mow tmo gne bbc
jpi: scz eqy qjh eko heb yzb uec
bts: cjm vsn lyx hov saq cqd cdq
ozr: fhf cdm
qoe: sfx vdq vmi fmz yxs tmm hrl diz bib
lrt: yww aza qmp vsn wui pdc hry
klf: kfl
xdo: jmx stz qvb thv xgj
zlx: nbm amv shg fjq
gmx: dck gyj pmv umq
obr: llv hwo ghw bay
mee: axe itd
dnu: ymc fei ppl mqu iyk
yed: qmt hqc
ule: lxm fcr jru igp nej slg ylz jdg
yzh: kgn ttx dhy
cbh: pym eoj hlr sgn
tgo: pib mbc jph
tii: gpr ynf iis ckt ggn jwf kwu
xwt: mmb sce
kax: hne nyf ipt
kln: yrr ads qon tcn
duk: ysw lfc
zzv: ivk tsq
cxu: npw thh rsl dvl gcg
dlp: zyy lob
zrq: rgx wyb vti rpq
mga: xvi fyc fgx you
uob: pan yed lii jdv
mmf: rwi qeo
npb: gvo cvr qax air
gvo: mkt eov qug npb scz tzj kfl prd
avx: uhh prd why xgj dlr lob
xia: uxh ppl fxk aza xtc utg
dhy: zat yzh
ixh: hlx iyl jln ayo aso ydc ioo
iqa: euc egh wgz
fxd: ctv woc ups
fjr: upp wip
wxe: tle tck sye eef fgl
yeo: pkr
yva: eny xry
gqy: kpn cev
zez: yay qkw nuq
jcm: rwy rxq hlf
jsr: kdu fuf gfi ioo
qdz: yer tgi kje
bwv: ugg qkc
rit: izl orc ovm
gtf: yur cof
qap: rql ifq cqd itd ipx ook owz
cbu: qkw uxz cnv rgx pib fbd
ook: cez qap jbj mha luq
yoh: lfc tuy
fjf: owm fwl
ofi: sax onf mtn
ggz: kiw shz dvd nyb xxg ybg trj
yxi: zfm guh bds wzz wug rtm zqk rev gwq
pyx: ntu szh qcp uob gdr yee tnc
cwx: vad pqq pkv acj zat
bbb: vby oqa adm rni qhf fyy
vva: stz nfm ywf kmz
zhd: tlf wjh rcp vyw ogu bnq
qwd: lbp mje ill zpi cjs aep
ihm: qku qjv xal wgp ran igs pak mkm
ydc: zay tls cdq ixh
ngf: jqp
kct: axx sax jry
xtc: xia can
hcc: nbw
vhy: vit svd aiu axq hlf zvz
iwh: uah yvt
zyy: nqv cdm sww uyb ctv qjp dlp gnq qkw see
kmz: hjn vva
sxz: bds fjf umo ivf gjj skz wgp
qey: jfz ibk
jlm: cpc yrl ngw dvl pat
kms: tsl ull fuy oiz frj
kdb: zyb awu
xdf: pse sce nir fei nte
dsv: iel hjw rbt
toy: bvo omo igs swz hry xtx tnz pon rge
qln: tqt rtv enx
uah: owm xzh iwh use
cwb: mwg xut jmo pom
iyl: jnz gcm dye ixh tjq tvx fnp
npw: noa ogu
shu: qqj rik
hxp: kar poq iey
qvn: xxg bkg rdq
ioy: auu gqy vbc amv eib
gyj: dfr yrj lne cij
nhu: ppl qip sun amg nus
kll: stx zxp yiw luq azc
ovm: rit ccg
pan: adc wao nbm lyw uwc mkv uob xxl
whh: ode
dsr: etp ann zcc wao
zkl: ylh ppl tjs
eln: uvm hrl fej spw coe ltr cun
ibk: skb aqc
vxw: zut jmq ran bwx nes pgl ode
edd: rcq tuc ftl yot fua yrj
ymu: pzs rww tbf
mmb: xwt vsn wff ogc
nic: qmp esm
pab: meu rsl dlp wak lzi
uld: sas rwu
izn: eus wpk ckg bok wff
fun: hum irs psa yhu yfr ffj ltj ufj
hqc: njj xgv stx yed coy dib bky zcc gdg rtm toc drj
dkq: wsy ykw yer jti
zvz: obn fpz vqy vhy pqq
ndn: llx htx uad ubu hey wya lmm obn bay
ltj: bmt mzi kwu
tcn: lbp cjs jme qpm kln
mzu: rdq umv xkj
ttu: mwm ayp erq
coy: bwi bwg tke
xrr: can cfg wog jsr pjm eur
szk: pee hxp srf qyr ohd ppi jwx smv
qrt: ubg uze jre dvt hsb vbp
akz: pju trj tvm
see: zyy yrl qug gsv
llv: vae ofb obr vnb ghw dvl tmx ycd rgs
yrl: sqg bwv ssz jlm ovb
pgq: skz yxs ejh
vyw: ojf cim fcr
nlj: ymj
hsn: ttx fyy
cux: rwi ywf dim epy lxm ozj
gai: vxu cck xif dqq
hvh: blq blx
rgr: fkq xgj mfo jgy jtq tfm
yhh: lkp tux ydw uhk
jmd: etp nic wsk fjr vxq tjq
skr: noa eov uhk
anc: gdr
lmm: uad ahm uld udg
hko: kgn xdo kaw flo eos thv lai
vjv: pcm ihb
voy: gne olk euw nki
gxf: zay aza qha fps
tdt: xry jlx yrj cma noe wic lyw
ira: aip uhk cso
ffj: prd gsv jph fun xjy fpz lhe
sce: pmr
htm: gbf
hqh: ssd fvi tpw zhz lyw
lnn: cdm exo pdy
xbm: lsp toc ykt uvm
cyr: kuj gdo iof zgi
dod: ffp
eef: peg wxe ydc kwo
hch: sye bwg ake egv
rql: ill qak qap
gcg: wjh uih xgd kaq ymg ngw ucw
lzq: ufn hwn
noi: wog qip dwl zjh lbp
ezw: dlj kcg oyk spj cvr
bqm: nes
wff: cls
fei: dwl xdf ohi btl
szh: pne mjy
slg: tur ocw gvu qdz tuy
rxr: xzh ejh yxs grn cvl rjq dcb
llx: tzk lxm vti
ami: etg wwv raa lpb khx blm fnv
jfa: zpi iuc zyb fii gib kid ake
hoz: yjg upp pee xtc
psx: dck jxs tnc bmr
rio: ckg tck ylh
idy: eka iim vwl wrv
czi: nqf cif rwx swr jqa zcj
auu: wzz tye huf alx mbf waz pxo aso ioy
ejz: jti tuq
lpn: taw rcp gkt
dhz: xfj nfi grn dcc pyu
bay: rep ndn wjf obr tdr uih yif lfd
ycd: vhr rwu cif hax xhs
irc: iis bid xsr sxe
wrs: rpf ogn iyx tsl vva
uyi: zmi ayp vrn taw boj
edc: iyk sye wni czs fhh
kwi: kwz una
qah: vjj zlx kcp inm nct
ahb: bkg qmv qtv fda
rsi: pkv vic izg tzj pim vad ekl
sas: khl uld
fzv: vgt gtf mxd
uxq: aqc ejh sze hul aon
wno: vjv yrj zlf ruc
ios: sri
dlt: exp
dim: vbh xsr kee tie cwx che cux irc gnq
gib: jfa icv ckg fvi zkl
rsl: cxu pab cif rsx
xgi: blq
yiw: prz kll skb pep seu auj
zmc: wqi sze
cwy: stz hlf rgs spm iyx kov
acf: aaf jtq eka
ltv: lfd uec nbw ssz vwl bmt
vdq: khx wno fjq hdl hnj qxs psq
gep: rek ddw
qax: ayp
rdq: lqz mzu vby qvn
odk: erq gaq lkp hbb odg vgt
ifq: mxu uce qap pgl ewq ymu
pmv: pak ijw rkq igs gmx wni
gfy: umq
bcq: gmg tsq qkt mkr
icw: fzd zlf fdg vxu
mxc: ubj uym
ykw: toe
ivk: auj zzv
wtz: uce vqg
pmk: oyd lnp tpr rhv
tjs: zkl skk qxs
pmr: gsr zxp sce lii lgy
tqt: ovm yzb ozg dlr
ioo: jsr vbk
bvb: ine wwe cqd
rgs: iom yjo xzu
qug: glq gvo see
elk: wla yay gul tvm xgj
saw: qha hbp rhu
rtw: gvu ejz ufr
vbc: pog oqu
odg: odk iyj mfo hlr xif
sit: cim ecj mah gth
dye: yhl wvx cee fnp
hwn: itq cee
pxq: sap jws
vdt: sta tzj xsr dif dvq wgz vci
vld: gai huf pxo ssd xbm npn fyl
oeq: nfi fdy
iab: jdv mrz xsk
tyc: tiu mth
ewi: ode ppl
pnl: huf ccu wno kid lee gsm vna
izg: rsi fda wsg qno hcc amc
drj: hcx hqc fjr yvt bok dvg kcd
ccd: owp yzz nef
gxo: ntu fqd fps pon
rek: gep ine gru ifg skz
ocw: zxv hzj slg gne ylz jws ira
lhd: tpw iey ras qux ivk
fgx: zwo qeo why
xif: wvu rpq gai qjh trj
dtn: njj qmt dcc lyx
kpb: qjd lyt pep ohi xkg gjq djh yva bkx
wya: lzi rgy bna
hzj: yzc wji tfm qxf
rvr: dvn gth vrw tzj uad jry
lpk: ztv fzd pau hul
tke: hpt qpm
evi: gcb mbx
lhg: sri fgl rev cij
fyy: fxp loa utf bbc hsn
cjo: qxf pnb orl
hyt: xbj nef xsr bog myi hwy
mvj: mrg rti ybg
cof: gtf sdb fzb vby qoc una vhg
pus: gmg
kcd: drj stx kjt gaf wpk
tuq: hjw yoh bmt ejz mrg rna lpn
qhx: fta uvm kjt ymw
blq: czf xgi rjq gru hvh fdy wgp gep
qet: ahu irc vby lfr
jdg: dlp job pat uxz
hbp: rql kpn icv rtx bts dye saw
dcb: lsp rww jcv rdk rxr
enq: drv cmv rgt ewi hnf gvw pdc ras
dvg: jkz mdd drj aty xzl qey huf
usx: mtt zbh zpy uks
dvq: hnt noz yzc zmi aiu elk
qkc: zif bwv
hlr: mzi vbp cbh slg rpq fsb dvq
fic: gaf uga mim
oyk: fzb xhq jre oyd
sww: gvu noa hrg qog fbd tsf loa
pwt: ghd utg gfi
dmw: sfq isw vrw bzd jwf wga gvk
gsm: eie spw ioh qon
fuy: vij kwz ynx kms riy trj tim
euw: tdy nao
hwy: rtv ore
vri: jre enx jry tru
ppd: qyr fyl dib wui
ppi: rik hem vmg bvo yhl
uuf: xri znf hnf cjm
kcr: wug aut fwl xut
aaf: kgn zev lqz ynx acf
tma: qet lai iim vas cvr iyj jzz
sqx: ntu yrj
riy: fsb adm zwo fuy ore olk rdq ftk lzi
qkt: bmr gdo xzl bcq bkx
lbh: vby qvb tdy wjf oyd xlf dsv
tsf: xkj wqs vtm bzd ego
khm: jym zcc qxs
knk: djb tkk zsu pat
ypj: yqq xgd uld
mqu: klc hlx iab dnu qrk
kxt: htz qey lqv ymc gsm
ydw: ial yhh uym bgx iit jti kfl
rev: lhg lee ydy ejh dlt
tbf: wip pee
hwo: day pat
pgl: nbm vxw shg
swr: oyd tor
vad: kxj dly
utf: fyy bkg ydz
wjf: bay lbh wjm vby
rfa: gpr hjw bna gbv lkg ofi yif
rcp: lpn qvb nqv
nbr: skb gru xal
zlj: fic vbk zby xri rgt xcy whh
tvj: eos fpz zbl tsl tpr ejz imb
zlf: neg icw dce
amv: ioy
nqv: eqs mjl
psc: djb ybg
sfx: gqy fau eur tja qoe
cij: lhg pdi njo
wvx: dcb ebh ctg gfy dye fnp qak
rgy: uhh wya
npp: awu tjq sty
fqd: qon ieu lpk zch qap tle gxo
qip: ztv gdo
wht: wug cmv
ann: jcv ejh ngf
rbt: qcz qlz fgx dsv flo
man: uux pef ugg
igs: toy qon cpv kwp
dvz: nsq
job: fhf gvk nuw
ylm: bed ovb imb
yhl: sri
iho: orl lkg zrq zap wsg gdq
uux: tsl ahu goe nlx yzz xhs jmb man jti vwz ssz
scz: bst tru xkj dod fvu jvb
vzf: xuh rcn txf nlm psf cjb ymw
xxg: nao svd euw nol ffp qvn ggz
fda: ahb ylm tlf wgz orc izg
jzm: vxu fmz jos drj fta mar dtq
kte: ahu cnv usa yre
udg: wjm zej ghm pym ull
qjd: dck gjq npp yjg mth
xhn: yes uxo szr vic ltj jwb ali
ohd: zut avm ihk ggc qjd
ldj: qij pcl
cpu: rug ahb bog qun ymj tkk jbb
spj: fvu whz ezw mmv tww dvd zzb qog
iwp: los isi mkr
npn: vld smv nte khm ppd psw
khk: rix klk
bog: zmi ahu hyt
fsb: xhq imb fgm ubj ylm
rdk: hry nbm sqd
alx: pdp aig kdu cid
xrk: pim jzz dui cso igp
enr: inm pus cba lbp qjv wsb
cma: rtx ffi
uhv: eov lth irc ema
izl: ema eyh dmt mtn rit
pib: npl tgo cbu
ttx: tkg myi hsn rsi tor yzh
ljf: csp amc qcx
ifi: eur yot mar
zfo: loa mah suw qjo
luu: cnq tls mvi ffi qxs yxs
htx: moe gbf ndn clr pky
mzi: ltj npl
owz: ifg dcb get kwo
wkf: zif lob umv tkk kov
tos: nef lmm yeo oiz aiu woc nyb
ymw: vzf hem
yfr: uze fun cxx air hcc fcr
zyb: jfa qns mtt udi mrz kdb fmz
obn: zvz ndn
rti: tgi zej mvj
sax: ydz kct klp ald urr ofi sxb
cqd: bts cid anh
pau: lpk nnt tnc udi oir
dya: axx pcl
iyo: jqa jzz rti ira nuq
vqy: srp jdn zvz
why: avx
cid: cqd alx ydy swp rdk qcp bqm pti
bmr: iof qkt dcu
vtm: oyd ypj ywh
tnu: aza lgy agg sqd
pdi: khi cij rhu aep
cev: mzj
kls: ihk xia whh xmx wqv oid
fpz: tvj vij gsv vva
vsn: bts lrt
zch: fhh njj isi uwc
hum: mym srp pxq jry zzb vgt fun mvg
ali: vwh ftk xhn yzb tie wks urr
wak: zwo
zkx: fxp fbd heb dkq boj dei
fhf: ozr rwu xbj tvv bpy mfu hsb nuw kzg job ict
iai: rbq vna wao blx fyl tle qak xqb
dza: fsy lyw scw mim sby
xlp: wgq enr oap fir vxq lbf
rsw: zcj yjo fxd mah fnt mym qlz qun
exs: fgl zay wmr njo mbf stx
jre: pkr
wip: fjr vuk ymw jly fwl tbf kar fnr mha zvc lbf hzz fcd
vxu: gai jzm icw tnu
jwu: tuy dui
qmv: tmo ego zez ahb
tru: fcr vri
jti: ydw uux ipt tie
yot: qha mjy ifi isy
vna: smv zzv
vic: tkk
poc: uwb stx kyc ohy eie wgm
wpk: izn qxs kcd
npl: pqq exo mzi uyb dvn jbb gtv pib
nef: clr zah ccd
xsk: zpd iab lgy hnf
xut: jgh vqg cwb jlx gqy
yjo: jsc ore hcc
ohi: jlr
dvd: ggz ntc lkg gcg
imy: gaz rpq isw ozr bst qsc gtf woc xjy
rub: ofz ywy yqq
qsc: mwd
owc: bmh ipx
tgi: gcb eka jpi ybg rya dvt qkw rti mow qdz
psa: pkv vad fzb stq qhf luf gjf
eku: uan aip axx cib goe rhv ubg kzg mbc yer
bpy: fhf you rep mjl viz gkt tmo
xzh: vrt erp fqn dwl uah bwi ffi nhu rxr
nbw: srp bvq hcc lfc zmi
xxl: qha fir
pdp: alx mim szh luq fps azj wwv avm jcb cyr mmb gjq
ura: ity
zdb: jym xgi wao
fzb: ogn mwd oyk
ntu: cyr pyx gxo ykr sqx qip ctg can big
jxp: bfo mrz lii tvx msy mee
cim: xhn yre qij xzu gpr cpc nuw vyw sit
tsh: xnx tru air klp
tnz: ioh khx pln hqp fii zhz peg qyr
vij: ofb ahu fpz qhf
par: kpn rkq fua
bzd: dmw jkc
rsx: vrw mjl
uxh: vwk jnz xia sih
ylh: rio ftq fii zkl
tax: zll qkw zez tqt pif ttu aip bnq
uqb: fhh aon
uvm: nlm yww eln
rge: iyk owm neg
rna: kzg uze hiy jmx
rwi: mmf cux pdy you ctv ggn
spt: jcm vit ckt
poq: can oam vrt hxp
dei: zkx xnb wup dlr
nnz: avp gyj cls oeq sze rww bok
wim: tdt cot twe bky bfo fzh
zbw: rkq gxh hrl yed hvh
bwi: hrl uuf
dag: mfu qax jms wga
yua: fge tzb mbf ddw zut xkm
iyj: alp nol tma cbu vrn
sta: vdt mkt epy egh ozg
vrn: iyj dfw mxd ofz wjn uyi ubj
uyb: nsn zah zyy yif urr yzz lnn yzb
ppl: dnu eni uks yrr ewi hpt xia
khl: rit cvr sas kka tmx
mbf: oir auu
fvi: trn hqh wef ouj fuf
kib: los fvt ssd
tux: puu udg ull
zme: yrr fhh
gsv: fpz see fnt
tkk: vic cpu dfj uwy
cot: qjv pep
dce: tck hzz fqn iwp gmx zlf
qux: auj rio tvx wgq
tpr: uuw wwm pmk
chu: izc saq tls los iuc
cxz: xbj ylz tww wya gpr ncs
che: zwf dim hwo ywf cgn jph ull zap
xal: nbr hem ijw
qij: cim vae gtq ldj sxe jwb cxx
cvv: ego bhu hzj epy ltv
njo: neg cij oex qku ogc qon cwg
ufj: ynx ngw vas yzh gkt
fnp: iyl
mth: dfr eib
coe: jbj vwk
rww: ymu nus los wsk
ahm: uym tdr
rgt: enq
mdm: nlx mlf zbl jbb kte fgx wfx
gvw: mvf gra
vas: djb soa
ghw: ssz yxl sxb eka
tzb: ebh zpi njo wgm psx auj psf jxp
gjf: ghm dfj ekl nej hax psa
sih: ukc seu
lqe: cdm zvz alp goe kaw
bnv: iel gdq goe tqt tmx
ran: vxw jos aep
oly: iit mvg nzy rya lfr dlp mzi
pog: byt rql vbc gjj
hem: xal
eqy: jpq jwb
uym: mxc ttx ahm iqa wvu eov njd
isi: iwp zch
knd: ghm qze gul soa rsi xvi gqb wsg sxt
bhy: wht omo qip cfg
luf: psa pnb
fps: cvl gxo rgu
gvu: bzd rtw elk slg
sby: pln dza bds ebh sce tmm rio
rzl: big ine wwe ohy hvh blx hov tle duo mxu lhg yww gdr
umv: ksi rep eos bgj
xlf: lbh
xgd: wsg yqq
zjh: skn rkq ukc noi
swp: gys fuf
lkg: rfa vyw dhy
gwq: rtx fhh cpv
gcb: suw tgi zev vri evi xlf ggn
tya: dlp dvt vit lfr eos
bwz: cjs neg ctg
djh: kpb stm cfx
amg: lyt nhu qbj
skk: scw fgl ezy tjs xoc
nao: xxg meu yay
qjp: fbj xvi spm
nyk: aut dlt pjm
heb: jpi ull qjo
peg: tnz btl oap toc fdy wqi jmq eef gra
gvk: ybu
dly: sap qjo vad
rpf: jvb ahb wrs rdq nyf mto tsl ogu bid lai
jor: goe ozg jon qax
ahu: aiz
fcb: djb wwm qtv
zbl: qhf
pnb: yay dcg luf nbw zej
igp: ule kka xrk
azc: pxo kll zdb srf
ull: kms rep udg che
sun: iwh umq shg lgx
cjm: uuf bts rik
jkc: enx air sgn bzd nqf kje exo
bhu: fxd mrg tie ysw vtm wup cvv
cub: eqs grz dfw tmo
alp: cvo aiz
pkr: jre qrt udg yeo ulb gcb iis nlj nsn ojf wfx
uwa: ydc jkz noe coe mkm dza bys vjv
ubu: ojf dvl rsw rtv
sye: cpv ioo rdh bky hch ykt wxe
hjw: tuq
woc: ijo
tnc: jym pau ojg vjj amv psx vmg
byt: big dtp
yqc: gjj vxu jym
kuj: wwe cyr gys
bok: izn nnz
dfr: kwp cqd xwt sfr cck fvt oid gyj mth
cmv: tdv enq zvc fxk wht
lee: pnl rdk xtc zcc
okp: lnp mym euc shx bed qog pef hzj
frr: ruc khi bvo ras tid
axx: kct dya xsr ore
wgz: fda
mbc: eku jms xlf tgo kct
ayp: lnp qax frj
sfr: zme uxh isi ios noe dfr sih
kka: qtv gul vyw wbh igp eqs
fta: qhx bmh jdv ogc
skn: wwv luq egv get waz zjh znf jlr ykr mzj
rni: bbb bgj
psq: vdq get stx djn
gbv: qmj gtf
tpt: wks nqv waw euw sxb ulb ego idy
ndu: wak uhh wko jvb flb pim
sgn: glq mfo wax psc poo
jlr: esm ohi khi
yzb: yoh qjh yzh
lob: wkf dlp eoj sxb soa nsq fsb avx jbb
cpc: jms dvn vri
iof: ewq bmr wgq
zhw: dij tnu udi mry
yog: swz gmq pcm vpg fau jgh
zyn: ssd cev pcm sfr wic
kgc: qvj hbn gdg fsy
toe: fgv ykw nuq qhf
fvu: qmj cvr dod ijo
ncs: cib ydz
mwg: tjq kwo anh pdc cwb
uoj: hmx zcj kct wwm kfr
ufr: jph qvv dlj bna
acj: noa cwx nlx kig dya tvv jwb owp
olk: zat riy rya
hie: rep vbh adm oic kov
qxf: glq bog cjo
txf: ftc waz gmg fau
hrl: zbw rgu
smw: tls jme umq vhw aso ckg
rcq: kll jmq edd sso pji dij vmg owc gmx tcn
fbd: vrw cbu zkx
ita: jru eqy you ura ubj nej hne pym bgx
vhw: smw avp ylh wxe dcn lyt hcx
djb: jqv ejq vas qcz knk psc fcb tuy orl
uhh: rgy iis avx nuq kms cib owp ict ndu ezw
xnx: mfu tsh ncs evi
yur: tor tuq fyc gtf jtq hrg
dcc: dhz khx fge vmg pon
eni: big rhu pom pyu diz ylh mdd gjc zmc ppl
czf: uwd dsh msy czs
ymc: ihb add
qxs: vdq khm kuj wpk tjs
zll: kfl ssz ipt tax
wqi: ayi cba udi hul bkx zmc fdy wtz hwn khk
