fqw: bzf nkm shk
brq: sjj hkr rvv nvq dgn qxn
vlt: sxk kxr
ctr: lkn pbb pfp cgk sbx qmp tqj
zfd: lwl tsl
hqj: gdq zxr ljs scv jmf vjr dzt sfc
qfw: lxd bfc dlr ddw zwj
mzf: xch
sjj: brq gwx zgv qnp rwj bnj tdr vwj
zxc: sjl knq lpt trx
crs: vrd dmg clb cdf hnz
hvx: tns wmt lhz
zwb: ccp rjb fqd xpg
hww: mqr jrj gzk
cnk: jgs gpd nsv blj kdb dqd spt
kpr: rhj xjc scv
nkm: fqw dnf jwh zjq vvv rlc
xls: shx rtr cqz fvw khr cxl
dhz: dlz cqt xxk hpj bmq xzq nqw
prd: frw snp
vrq: sbw lrk tpp mnt qzx clq gdh
pwc: kwj rzw lhr pqd
ptp: xmd fsh vdq mmt grn xfb
psh: lkz frj
kcg: bxw pxh
bhb: pgm clq nsh
xqn: fqd pmg swp
zln: frj mcc xwl
pcr: qhn rpg vxj rnm lkv wzn vzv
xch: gkx ptz xzt mzf fcx
lqn: ncx wsd vkg ztg zvv bvr
wqz: grn sbg
svs: sbg vzf
jvq: pkb gdd zlb
shk: kpw wcq gxd fqw fsg
ckg: zzp gsl jvn
lnm: lkz
jfh: pmg cbm xnr txp
nqw: bth sbl pnk
hpj: jqq vmh dhz gjj cdc kjh xfm pnk bst
pfc: jcz vxs kbm vkj
czh: xjb rgx mnm qql
lzv: khv qbr cpp qpt fwk
kxt: tpl kgn cfd cnk qqb rmj
cnd: qcf pxh dnd pnk
qmv: ktr rtj bgd srt mbb dzq
jvw: jmd lzx tqr qkx ppz zpx
pcq: jck lnk hzn jrf lbs pzx kvv
sdk: vrn cqt gwx vbp wwr xmn
zwj: qfw jng rgh qgf bvr
rdf: zzk qfc rfz rdd fft
hsr: hkh qml cnw mnb vhl knb rmb
czm: ctq kfl vxc
pzt: brv tbt vdq cfd dhv sjw
wbt: wjn grn
tpr: prt jgl bcp vgd rkg
rbt: xsg hxh
nnj: mkp dsf ggl gcv zzv jsw pwg zvv
ddv: tqr bjw lwg xfb
cjs: vtx mtc lbz
fhl: grr pvr txm vbj
bfc: hpt rvd
pwg: rtv xwd
sjg: jzd bfk wwt wfd xsz
xgm: qhh pnb jfg vnj bvj vrp jmb dxr lwg
csn: dfh gqb zmh qxp krv ptw bhl lbg
nqs: pqh
rvg: zmm hhx bsf jmb
ztb: mnb kbf mjl
fpj: sxk jvm zkl
qbg: kll zkj htc gsg cdc zxd rjv
vpv: zps kmd bch mxv jhq
pdq: pjn nhh
sfc: cnw qhh dbj brv
pph: ptw
vwj: pbm hfl dxs rcm sjj lsr wbv hfq zwx
ldk: bst xsl zzv
lpr: hnl gzk qdd hzs mnb
nxr: rlm zjb
qlw: mnt jkf szq bgw cbc nnp
pdd: sbx wrt hwh mrk ffs xvw cjs xnh fmm
pkb: sdv jvq zzk wxg cpm dcj lzg vqz
bvr: gwf
cqt: dhz wpq ttv wrv vdt qpt rdh nlq sdk spx vbq
vkg: lmw wsf swp qmn lqn vwb jjm rkg tzd
wbx: xks xjc qft
xsz: sjg kvv
pfp: ckh xnh qqm trx lpx ctr wmc wxg btt nrs
wtx: ntv ltx
sdd: mvp jhk smn fpk
qft: mmt
zps: mhg tpl xgp dlb kfx rzf vpv mdb
hvr: txp
wkn: hwf fpk zgs
zkl: fpj klw dnm
nzr: vzk vsp mxz jfc lfm flq
qml: gff qdw
klc: khj kmq tsr pzf zmm thb bgd qml
fbs: kwd nsv lkp rts xzs qnq nwn
qzd: bmj fxd ljl lrk kzt zsv gss vbz
ljh: vlv ggb sbv kmq kdn tsz wkr
sqf: qmd njq nxs jrq qgg nbp sjj xfr vhr
pxh: ljw kcg
qds: bjw lzx fmm tzr nvr lbr nrg cwf qnl
mjn: jkv
rtk: tnt lhr rlj
sbm: zdq rql hlc vdh
cqz: xls zhs xvt dfh grr
qdw: ppj
dxn: fht xjs gmd
vxc: dbh czm xln rgq tcp pqz
bbz: lzx fmw xln
jnh: gsl rjw pdk tjk xzq spx lbb nhv rlx sqq
ngs: vzk qpc tmn lpt spt nnk tjv dlb
bzt: cgk jtw chm
xxs: pnb zrq hlh pqf
lkk: vpl grd
hgw: xgp kqv vrp qfc qjr cnh tgw tjv
jkr: clx xmj rbm rlw vbz vzx cbg wwv jrn nsq nlq
kbl: vph snw hmb fxd dxg frz gsg zfq bnq
ccd: rhg mgq cps qcx wgd qgg
vzk: brp kwj
bfx: hxh zbj dlr
tqr: ddv flx nxv gpp hhd
zgl: gvn bqr pjb qgg fst tgv gjv bfk sxk pqd kzh
hpp: zlv xmj vxd
kwq: rgl wpq
shx: xfb kwd vnb mcw fbd kwb cxl xls
pqz: rlj xgp rmb ghn vxc vgc ppz fgs
mds: wdw fjw
mhk: wsf cpp vgd bxn
vnf: hbb ngt zbj qmn bdc
lpt: zxc nkc wxt cmw
xrv: pcn hgl
xln: bsf vxc tbt bbz dms
ppq: vzv txm
gtn: wlp xwg kjz bst nhv hlj gdc jnh ttr vbg
xff: blh ngx rtc
xnl: cjz zmc
jlh: jvb ttm
dbg: ckp wwl dkc drr
rtv: qmn pwg
slj: rdv
mqs: sdv vqx ncm
vhd: dbw nzj njg pcb
mff: lxd tdf vbz khh kvv
rhd: lvn ppn wxp
zlb: pbp jvq pwb mdl
qmx: hkh kpw sbv qxl
ltx: cpv kwj ntv wtx mmf khj fdc qnn nqs
xzs: vgp spz
hdf: jsn hwq
xwk: nct kll cjz khn spx wdq vtm nqw rdh lhz lbb
nqr: jmf qjr kml jbv
fzf: ggb
pns: fsk rsd btg kpw srd
bss: mbl jrw
xwv: bkm hwz nwz ftc nph vzk
hsj: nfq tvp
bdc: hhr xfr sxk vrm xwg jwt fzm rvv qbf
prt: tpr pmg fkx pzb
flt: jdl zsk vbz spn pmv kvv
tqm: jfg nkg tct trx
jhc: zsk tfp rwf
bpk: hrm qjc twn sbm spt
lqz: kgl nmn mdn pdq wxp gjv lsr wpz
jrg: prd bwd zbq vmh
cbj: spn vmh snp zqg nts vrm vbq wsd
tns: zxd xjl mrv vmv hvx qxt wxk cxp xdf ktq
mmz: fvh rvr jng
ldn: zfr gvg nsq mxp bfv
cdz: pkj khn gkj tps rbf gcc gjj
vrb: jmd rgq vbj frt qqz pmz
zmm: nwb klc
mrj: xlk ksd pcb mzb
cbc: ttr
jgl: ztg rrm sbd
dtf: gsn tcf gbz nln nfx
qzf: brv znp rzx
rsr: lbj pdb mcc bsq bnf bgp cql tsk pzw
hvn: tcz rdf
qzm: zsv bzk hvc
dqw: xwg qqr tgv wwr jmh zpc mqt
xzd: xdb mxf
trb: nxs xwd nnp zzc wjf hnm
bth: cqm vxd nqw glz dbc qsm rjb ppc jjw
dcz: nwk lkw dtl mfh bgr jtw fsk
pmj: vcm cqd
tff: szt brp
zhs: rpl cqz bgk
kwj: zrq
nnp: qlw qnp
zss: sjh qqz
hbk: nhh kjp ksb zkj
rqg: hqz chn rdx nxr xtk
xxq: rgm zfd pmt
qzp: pns kbq htv qpw bqw mvw dxc wrh
vnp: fvn fbd htv
xwl: bkb
grj: sqq wwr vzl rgv zsv vwv vvg rcq cqw
vxg: kwf
qqr: hrd vjz frz
twt: vwr ljg rjw
rbf: cdz cqm frz qwv
fjw: rth mrv
fpk: dtn rjw wkn
xmn: sdk qfl nrq brk wwf nbp wns
pzf: rfh klc sql bwz
shg: nnr pxc cpv clp cgg ltw lpr fhl
rnm: kth klp hcg kbq
jbj: cvd
rtb: pwt jmb pcj dwb
lbr: kjx vpp
bsp: vwn npc zrr fnx fmw jcn rfk hrr
ckk: vlr mnt ftk nfh wps zsk fpj rkh kkk
hgl: zdw lkn xrv ghm gms jvw zss qrk nfq
bmv: lfm qnn wkr nhx hnl zss jxg
ntq: qzt nlq tpp mjb rcm zfq
lrt: zdz hgg cpm
cbm: bxb zbt kxr nrq
gkj: zsk bnf kll xpg cdz
nvq: nht zxs lxz brq hrg
pkj: xhd lzn qlz
rbm: gvn kll jkr
dnf: rlm rhj kvx
hpg: pjw tpr pkg njb tfs jpb xhb kbz
qcf: zcb jdl cnd
wwr: ctv sdk snr njq
knt: gsl zzc psh
mnb: hsr kvh
clp: shg fbf
zbt: hwf dtn vqb vmd cbm jcx
ghg: sjw zxr nld prw
rdh: xzr fkz wwl dcg xwk twq
ngx: gwx zsv zqg xff tdr
dcx: qbf tbq
vhr: bfh sqf kgv jck qpv srm jjm wxp bsq
rgv: pjn grj
tch: qrh jjw nrq rfp vgs
dvz: wdw sbd gvg fjv dxm gcc
prn: ngb khh kfb njj jgl kjp
qbf: zcb mcl bdc dcx
kjm: qxt cfz pmv rkh qwv bgf fjw
qdd: lpr vrp qqb nzz ggg tmz btt vwn
mhb: mvp wpz gbx zzt zls zcb jjw cmk wpf
dxk: nvh
spn: jmw vwb cbj zfr nhh
wbp: fcx rkf bwz lmt bzr
zzk: xmd lkn pkb rdf rts pmj
bwd: lqn mnm wsf kwf jdk cdz jrg hjd zwj rws hrb nlr
csd: pzx blf tlf cnz mvx hdq
hfc: dwb cjt
hln: cpx xsz bzk
qwv: dxs wrg prv kjm hlz ldb mnm mjj rbf
ckp: smn wzb lhz bnf rmd hwl xsj zmp dbg sjg
ksd: lkp ppj gpp cqd kfs hww hqj ljs mrj mjn vgh
jwh: npm btg
znd: nnr gms mgg ptz pms dms
jsw: nnj nbp dsx
dfh: hnz qck
zfr: wcx spn ldn
hhx: ptw tbb mjf
nkw: cql xsg mbv zmc gjv blf dxn dsx bfh vwk
gvz: dgn
rdv: zvt mkz slj fzf jvq
jmx: dvm hww qht crw tvl qcz tkv zrh
bsc: lbg mxj hwq bwg vnj
fmw: bbz wdj
sbg: wqz vvb ftn kmq svs
hqt: jkf
rzf: wbx vvk whr ftn
fvv: cfz knf rvd
mvg: knh xhb ngt lkk qlk
jvn: fjv khs rvr smb ckg
tsz: ljh jkg jfz twk rtk
ltw: bch shg pqd ldc
tbb: qxp sql bbj hhx npc xwn
hpt: nts kxr vcf vkj bfc zzt
pdl: vcn nfx cgx
jpb: wxs hpg hwl gmd xdf
wzn: xgr zhs wlt lhq kfn
xzq: gcc cpp
qts: wrv mds jvb kft qcf ntq clx ngt rkh qzt khs htc tmj
zvt: xbt gff kfl tcz
vmh: kms wns zbj jrg
klw: zvv hrb wwl
qrr: mbb bgk
fst: xfm rtc mgq fbj
mmq: zxn xqs
rzv: kbm lxl vgd drr spx
hmb: vxg
nbp: sqf tfl jsw hqt xmn kkk jjw
gxr: dtl jhq xdw
jmd: vrb gpp
zkm: jpx jsm fft zpx tsr xwv zjl
xbq: bsq hqm wfd
srm: shz fqd xwg
qmn: vkg cqw rtv njf vnf qzt jsw
bfk: ggc nts gvb fkx zgl ksb njj
vxs: lfq
xjb: czh hkm wbv lwd bzx kdh wts kxz
shj: bnp gcb gbx qzt ntq xgc xlw ckb hdw
sgg: zsr pnt tqq vrd
lxz: rcq wfd
xjl: tdr zbs qwt mcc knt
mcg: brk zfw zfr
jqq: wcx zmw vwv mwg hpj
mrk: ghm vhl xtg mgr pdd lgt lzq mmq
xqz: wgd ppn kmt gcv pmv
jmc: hxh wxk hrb ngb qfw
bvt: sxw spz dms qqt nln gjq
wxb: zbp rtk vzq xlk qrz
cbg: nfw vbq ftk tng
frj: chh xvk psh nfh zln wpq
vmd: gkv
pzx: pcq
plv: wzb wxp mrv hpp cpp rfg llz lkk ldw hss
thb: klc npm sbx btg rtr pbb
nkg: chm pcb
pkm: xxk xsr qnz rws
pwp: qkv vbg
vcm: hlh mvn jzz pmj sdv
kwb: dtl kfx nld zrg tcp
bqw: fdr
qnp: sjj nnp njj zls pbm
rlp: ngb fzm lxl vgs knf ggc
rfp: lqx xlp qmd tch
rgm: xxq zjq xwn zbp ncm szt
mbl: swp bss tfs jnt
kjn: rpt ggz nqs fhd
wpt: fjr ktq mwg zqg
jnt: mbl lgb wpz
bqr: zgl hcl gjb gts rgh
nwk: rfm xqh pcr mcw vjr dcz qpw qzz wkr mgc
ggz: xzs chx bbz vcm kjn
vgd: mhk tpr
nhv: gtn jnh jmh wsf qgn qcx
srt: gdd flx
grn: ljs wbt wqz hsc zhh cfp dms rfz ptp
hnl: lpr xtk mgc nfd nwz gsb
wts: zkj cpp mjb nfw mds xlw zxd qxn
qdk: zgv zxs lxl cgl zfw
ljl: hbb
drv: mxk qjz
cqd: jdc pmj qrz xtk ksd sww
nxs: xpg svg szq kzh trb hpg
frb: vxj zdq tjm tlv pjr
ncx: xsg hss frz lqn
wdw: pmp
njq: nsq cqw wwr
cxl: xls cgv shx krv
pnk: nqw
wsq: njd tbq pxf hlj fpj mrl jhx xbq hcl
twm: xqc bwg vbz
lwd: kqq rsq nsh jcx cfm pcz
szt: nns rgm tff hbq
mxj: lwl sdf cwf mvw
hlj: ttd kdh fjw wsq rtc
xxx: bvt xpl kfn mmq vgc xtg wlt ppl nwb wrh
srd: swt ckh nvh rpt
mvn: fjz
qjc: bpk ppj xjc wqj rln
qkv: pwp knf jpb tdm nxs
fzw: xmd hsc wtx ksx nqr cnk
fhh: gzx rpl bgk cgg dhv vpv hmm
fqs: mdl ksx mjl
zvd: tcz htv
rrm: kbz jgl pgm rbt
hlc: jtw qtd sbm
tmn: ngs vkv hdf hgr
pfx: pcn pms qcz bhl xgr dwb kjr
jcn: bsp qgz vnz dwb bbt qnq
hss: bnk dkc
qfc: ffs ctm rdf hsj lkw
kjr: wpl pfx hrr bwc
mkz: dxb rql
tsk: qkz vmd gxc xjs lzv vpl rsr
xsj: ggl jvm kjm vxl rlt
bdb: fgd wqv hdq swh
vwb: tnz spn xfr
nts: bnq wxr hjd rcq hpt
sfb: jzz lwl
kvv: flt rph wxx
zxt: bsx kjz
rvv: brq pkg mcc
krv: zjb zmj vdq cxl
fkx: bfk prt
bjw: kth kfs wjn zhp mkz ddv xqc fzf
zrt: kft vwk jls qfl zvm lzn glz vqj
vqz: dqd mzf mrj
hbf: cgl lhz rjw zgv khn mbv snr dbg nlr
srg: vjx zrg jfc fsk zvd
mqt: dqw lcz bcp xmt
jrw: zpc bss
wgd: wdf smn sgn mrl
mbv: hbf lzn fll khk qlp bsq mjr nkw
pdk: jnh rtc
wth: mjn dxc bkm hzv
zxd: pgn jnh qzd zfr ttm
xmd: zzk fzw cxd dws dxr vdb jsm jtw lgt ptp
jvm: kfb xsj jrw
rkf: vgq
kdr: ggg ppv xxs jkt lqc wrh bzf
jcx: zbt smh ldk
tlv: zhp jsm prw fsh
hjw: ndf hqz pbp qnq jfc btq
zzp: bxw pbv vlr bmq ddq zfq hjd jwt rsq qbf jls ckg hpt
mcw: nwk zmq zhk
ssl: kpr prx ltw dqd qgz ftc
pcb: stv vhd
vgc: qrw pbb qft
bct: jwt ggd zcf wpz pfq zwn prd qqr hfq kbl rsq
lmt: wbp wpk
pcj: xtk
jsm: kqv
bld: kpc hdz wrp rfm
snp: cbj xcz
zhr: rwj zpc xwd zgs
gcb: qlk hzq gvg
xgr: pfx vvb vvm nzc
vwr: hmp clx rkg prv
sxk: bmh jrn hpp zxt kwf fpj mhk vlt lmn vgs bdc
wmc: pfp kdb klh
bgp: klw gjb
lqx: qlz rfp khv dvw pfq dsf jnt mvf
txp: rzm zgv cqm bck vbp shz qnp jfh hvr
dcg: bsg rdh pwp
rtr: xls qjr
drl: hdz tsr
hzs: kfn mqr tvb
lpw: tnt zfd cdg chm jfc cgx sht
fqd: xqn mvx vpl zwb gdh
stw: qqt mrj shk
rfk: wcq mhx pdz sbx
jbv: clb zxr cdf fjz
kqb: rqc nkj lzq wvv
wkr: vzf nwk ljh tbt
ggc: zmw rvd rlp mgq bfk jbp cfb bcp xcz
qbj: mxv fjz
swh: nsq xwg zcb bdb kgv zln
nfq: khj hgl hsj stk gff
vdq: ptp rpt
ngb: hrg rlp gfx prn vth rgb
xhm: wxx vjz wsd hcl
twq: ljg hdw tng
bst: wlp jhk xvr hpj ldk dxs
gpl: jmw bcp vph mjj snp
lfx: npm xtk mqw vvk nrs
jrf: pcq vmb gsg
tng: gbp
bxw: cgp gjv kcg pgt mnn
vvn: fmp wxs gjj
cqw: qkk qmn xfm njq
qlr: tlf vcf nrl ldb xvq tfl
xgp: tbc mqr wmc
sbt: kmd
dmg: dbj vqx qxl tsl
cfd: mwz kdn
vnz: jcn gdq qpw fvn
fzz: bnp dwr
trx: zxc btq svs
sxw: hhd twk zjl bvt zjn
jrj: zxj tsf zrg gdd hww xvw
jrq: sqf
tzr: tpl qqt llq
vnj: xgm bsc gbz llq
sdf: cgk zxr
ghm: hgl wrh nqr nfd
ndf: fcx lhf psp nrg
zrg: rln wbt kwb dxr
zzc: dlz
lwl: kdx bvj tzr mxj nhg zxj zfd qzz zhk bch sfb
lzx: wrt sjl nnr bbz
cjq: rlx qgn nsk lfq frz
zzv: wwh ldk hmb scs
tlf: ktq lld zvm jgc qlr csd
lcn: pjr cgx snh
gff: brp
cxd: xmd jfz sht tqq
vhl: mhg mrk wpl
xgc: rkr qwv wzb shj xpx gwf
tmz: jcn vwn hdf wxt fmz whr hdz jxd
nrg: pwt qds kth
mlt: svg wsd
wwt: zfk
snh: rlm lcn lns hsc jjj czm
hpn: bmj crv xvr nxd
fgd: tbf gcc hxq nlr wsd
crr: jsn vzv zpx
chn: vdv tct
wpq: qzx kwq
bhm: pmp ldw gcz jsw nqk
whr: vdv
xlp: dlk cfz wwf rfp mkf
twk: sxw tsz
qhz: tnx mxx knb lfm xxs
nfx: pqf ssk
kgl: qfw lqz vxd rwf vwh
dzt: gpd wms nxr frb mjf hqj dwf kjr jmd
wmt: kzm prv kzh hvx
nsb: vmv dxm pgn ckg zzc dxg zxt
hmm: ggb
mrf: fhd
hwl: ckp jpb
gzg: twm
jsn: lxr tsf lrt xfb hdf rpl qzf vbj rfz crr ztb
ljs: ksd vsp xzs
wrg: wfd twq
dcr: khh hlz wfd qdt rsq szq vqj tmw xjw fgd
hfq: tnz wrv vvl njd
cdg: tjw pxc fbd
gwf: zkl bvr hvx rgh
nqk: ggd bhm bck
pcn: nxr xqs qgd nzz xrv
jkf: zwk rfv wkn qlw fnv pnk hqt pxf txp
vtl: hwq cfp fft zmq brp
zhb: cnh mxv wbx
pzw: smh bmj wwf tps fkz
bwk: qcx nfw
zxs: hrd nmn nvq
flx: nbw srt cdf zhk
qcx: qlk skb xwd
bgw: cmk xvk
vnb: hgg ppv qbj spl hmt tqq
kcm: cpm qft vkv kwj gms
mdn: zkl jrw pgn hmp lqz vjz ldb
sqc: dzs kjh rkr nrl
wxr: nts lpg gsl
vgq: prz pns stw rkf kbf dwf kfl
lkw: wql dcz mxk btt
lzq: mrk pms htv lkv
lfq: nsk sqq vxs cjq kgv cgl bbw xbq
pbb: dch kqv ctr mqr
qjz: cjt kmc jpk nzc wwn ppl drv ctq fdc qrz
nsh: mnt bhb xcz vxs
zmh: csn gqb dbw lmt sgb qzf kdx
nvr: bzt
vln: tps pzb lgx cfb khk dbg
cvd: slj cqd fxm jsm bwc jbj fdb
qxl: qmx gll dmg vqx hzv kvh lbz dqd zgm
tkv: nln mzf fbf sjw ggb
xnr: dvl fzz dbc wxr frw jfh
bfv: kzm
kcd: hwf pvm wpf
scv: qwp
drr: dbg
kfn: hdg xwv xvw hzs hkh
stv: sjp khj pcb dms tvr
wlt: vzq lkn drl bbt rfh wzn qkx
vbp: zbs mgq rfg zln wjf sdk txp
dmw: kbh vdt
tpl: zps bwc xdw
bck: nqk tfp txp qxn
xwn: tbb pwb ksx hzc dxr nrg
bmq: xsg frw kzh xmt zzp
lxl: fnv rlp qpv qdk rzv mcl
mxv: hmq qbj zhb
lvn: htc vjz mjj rhd
gcz: bhm hxq
qql: nht msx
xmm: mvr sww tsn pbb kcm mmf
qqt: tzr rql
tvl: kwd lfm nnr hzv
rcq: nts sbl lxz frz
pqf: hkd nfx stk vgh xxs vjx pcj
kjh: ghs lgb sqc
cgl: chh twr khh lfq tgv lnk qdk dlr jgl dxg hbf vvl vzx
wrv: bbw
sbl: wqv nvc
lbl: hrr kfr sjl mwz rfm prl nqr qrk
khx: nzc pmt ftc
jwt: lxd zzp cgp
qqb: kmd mfh fsk gxd
lwq: tkv mxx xqs vgc jxg
ppc: jgc bth njb qnz ddw xnl flt
qnl: qgd zgm pmj
mxp: ldn pbv nvc
nnd: tjk vvj tzd qlk
lhz: gvb hvx mcg fbj
vzf: svs dwf khj vnb jpx fnx rlm ppl wkr jxd mjl jbv
hgr: xqh bcz xzs jdc tmn
pvr: fhl hrm
sww: kjx vcn zdz xzs cck
rtl: qgd qrr fbf bgk tvp nvr
fzm: ddw hwl clj
bxn: lpg
hkr: cbc fht tdr cpp brq
hvc: dcx jrq wwh wbv dlk wwl wcl qzm
vzx: jck wkn gjv
hjd: zzp zvv
gzk: jmf prw pfh dws cxl gms nzz cck qrr hww lpr
xdf: kcg wpz tns jpb mjj nfh
gjj: tfs cdz fjv jzd vvn
zxr: hqj kmc jbv btt sdf ghg fsh
tsf: jrj fdb
dlz: mnn smn zzc dhz qmd
htk: hdx vlv rmj qkb hlc kkp qrk hzv
klp: pms
rgl: nvc kwq
wql: lkw zhk sdf twn wcq nld
tbf: gmd lnm nsk ldw kzh
kdh: pzk wrg hlj hmb
rlx: jnh vzl cbc vcf cjq
nvc: rgl sbl gvb
mmt: hgr wdj jdc ptp ldc qft tmz lpx rdd
vkj: ffl
rph: hvv kvv knf vvl vwh wfj clj vpl
cpp: lzv hkr xzq
rzm: xnp mds mcg zwq fnv txp gss
gss: xjw hxh
bzx: qfl pvm xpx lmw pjw
vzq: mgg wxb wlt jsm fsg nph tsn
kml: hhd
mqr: pbb hzs xgp
jkw: jfc crw xdb tqj
xvr: tng zsk
tcz: zvd hvn tqw mjl mqw hmm zvt
lbb: njj
lkz: vzx qln vth lnm tjg psh hbb wzb vtm
wwv: jkr
mrn: khj qqz rzx rzw qxp
llz: scs
gbp: glz lvn pln kmt lbs wxx mkc jcx tng
scw: flt pwg msx rfp hqm lhl
fdc: ltx lkp
vpp: gsb jmp bfd
vxj: pcr gsb
ggd: vrq nqk vwr bss skb
zwk: bfh smb wcx
ppl: qjz qqm fbd gzg
tfl: nbp knf qlr lsr
pqd: hnz zgl sgr
chm: nkg bzt fft zkh tqw
kms: xmt vxl vmh
chx: pph ggz jdc
ckb: cxp dkc shj kjp msx tdf zqm
ffl: mcl gdc vkj jcx nhh
dxg: vmv cgl zgs xwl cjq crv
zkh: qrw fwn cgv
vqx: fbf xnh mqs dmg
hrb: jmc cgp klw
hvs: kms hcl chh dvl
kmc: vnj mzx tfr
fnx: zjn nns brp
rgh: gwf mfl zbs
hgg: skk nzj
wsf: bwd mhk nhv dmw vkg xvk
dsf: wxk nnj
tdr: fmp tsj sjj lfq vrq xjl ngx hkr
bnp: shj twr khk
dzq: gpg qmv
rkd: tfp bmq klf fzm nhh bnf lbs xsr jhx svg
tsj: dlr
kxz: xjb lxv rbt wxp
mwz: fdc lbl tsn hpk bgk cfd
cgp: hrb bxw jwt
rzw: pgl nrs mrn pwc zbp rfh
frz: hhr kbl rbf
nlq: bdt trf fwk qgg jkr ntq
vdv: cdg whr xvt lfx chn bgr cvc tjm gdq
smq: vbq lxv rzc
lwp: bfd kcc hlf zql
tjk: jnh zmw bnk nnd
rtc: pdk xff bfx
nhg: mgc cpm
xfr: twr llz vwb
spz: bvt tjw pxc
zgm: qnl btt ndz
bbj: bgr vpm
vrp: kdn qdd
cgg: wbt fdr jmp fhh
zfw: qdk qpt lld mcg czh
fxm: cvd ppz
gpg: znx sxw bzt dzq jmp cpm wxt qwp pwc dch
rqc: ppj xls kqb wcq
gzx: pxv hwz trs
vpm: fmz bbj mtc
rtj: pxc nln sjh qnl gqb cfd
zzt: lnk
vqb: zbt jzd
mzb: hzc mrj pqh fft gzg xln
kth: nnn cdg nrg
lkp: fdc mhx
zwq: rzm njq jbp bmh jmw mjj pgn
qpw: dxf zdw vnz vvh vjx nwk
wxp: plv kxz gcz rhd kms
qxt: tns wpt wcx hkm kcd
zvm: tlf zrt
gcv: rwj nqk
bgh: lhz bxk zwb dbp clq bsx
cdf: jbv lxr crs
lwg: thc zdz mrf
cfz: hvv kjm fvv pxf snp lqb
grd: lkk fkx
bbw: lzh
sjp: sql dws tqw pqd stv
pqh: xbt xwv nzc gxt zhh rmb mzb zbp nqs
kfs: ksd wms
rql: sbt qqt jdm fdc sbm
pbv: nsq rjx msx zcb jzd zqw mxp zbs rfv
vrm: zvm bdc zbq cbj hqw ghs
pbj: tlv rdf srd
gmd: vwb jpb xpx klf
kfb: jvm wmt mkc gwf prn vlt ghs
ctv: zfk fjv kcg gdc xhb ldb xwd pwp
twh: kgm tfl lmn hlj cbc lsr mvp
tmw: dcr dxn hln kxr
qnn: nzz lfm jmp rzx ltx
gfx: rmd qzx ngb dbp qbf
xvt: fqw kdx
vsp: ths qnl cwr jgs
twr: bnp xfr zbq pxf
fvh: mmz zmw zwx fkz
wjf: vbp hzn
gvn: rqp rbm
bcz: ppj htv mgg crr gjg bsp hgr
pkg: bgf jrq knf pkm
fmj: shz
qck: qxp dfh xdp ntk lhf mjn
dbw: tbt ppq qhh
tqj: jkw hww jbj ctr
vvl: rph qdt
rww: szt vnz dxc
mdl: fqs zlb mgg vgp bld psd pzf msl
wlp: wqv fmp nrl hzq
dgn: brq gvz
kjp: mnn hbk cbm hss nrm
cpv: ltx qbj jjj mkz zgn shg crr njg lrt tqm
gll: mvn ntk pqd pvr
tfs: gjj mvx
mqd: fsk ghm tsz vgh vvm tct qwp flq
bsx: zxt
fbd: mvw cdg wxg ppl
tfr: ppj gbz rhj wkr jsh rww hfc qck kmc
rkg: rjb tpr vmv vwr vkg pfq
spl: mgg llq rtb nsv jbj gjg
btt: jmf gmj zxr pfp zgm kwd qwm lkw
qpv: hbk kll hzq rgb lxl mnm
psj: scs jmh hbh vvl jdk pzw
wpf: mhb bzk ckg nts kcd hkr zsv
zwn: bct khh wdf gsl snp
pwb: fmm sgr zrq
mvf: fll wpv njb zmw lqx
dzs: xhd wwv sqc rjv htb tmj
nwb: rmb jmp xxx zmm
chh: knh cgl rcq prd bcp frj
tvp: rtl hsj kpc cfd rzx ths
dwf: dxb qgz dzt
wcl: cpx qgf rcq clq
zbj: vnf lmq vmh vvl fkz bfx
bnf: rwf rsr htc
fdb: wxq fxm tsf cfd cvd
klh: wmc fcx dpk
wfj: cnz rph
xvk: bgw pgm
ngt: lcz tps qts gbp
nwn: swt fbs vcn qzz
kkp: kmc xks ttx sjp
hmq: slj mxv kcc
sgn: vsg dnd kft
jck: vhr jmc vzx pcq
ghs: kjh rjb cdc mcl cfm csd grd vrm
nsk: hdq tbf
qgd: rtl bzf qzf dws pcn qnl
znp: fhd
wpv: mvf dvl pgt fkx vmb jcz rbt wbv
cpx: zbt zgl qrh spn wcl hln
wwl: hvc
lrk: vrq pdb bgf rth
lsr: wpz lqz fll
psd: mxz stw zdx
bbt: jcn ppv hcg hbq
dxb: dwf mjf nkj hnz clp mkz
prz: mxk hrm rkf
pzb: vbz qsm prt
sbv: zqx fjz
mgq: ggc bvr ccd
prx: fhd bch ttx dtm
gkv: jrw tjk vbz czh vmd zpc
vjx: gxd qpw zmj
gdc: gtn vnm ctv zbs ffl rtv qlp
scs: psj bfk llz
hhr: ttr bss bhb frz kls dcx
cjx: dxk bwz cvc
qnq: nsv hjw
xhd: jdl dzs pkj
zqx: tqm xlk sbv tgw
bzr: nzx svw mvn
rwj: wxx gcv zhr klf cfm sjj gbx
tmj: pbm zcf nvq dzs qts
fbf: psd wrr vqx clp tkv rtl bvt zjl ddv
khh: zwn qsm
kfl: zvt vgq kdn wpk btq czm
cnw: hsr brv mmq sfc
svg: jgc rkd qln mlt
vth: tsj ngb jzd pkm hmp
swp: pjw tdf xqn xhm trb mbl
hlf: pxv dxk cdf dxc lwp
tjw: cdg pdx
hnm: zqg tqc
msl: qfj fzf prl dtm
lzh: nts xvr xlw gts bbw
xqc: twm
gvb: lhz rjv
dch: vlv pbb fgs fzf gpg
mgr: pnb mrk
fft: chm ksx mzb rdf
tzd: rsq hkr nnd pln gcb
msx: qql
hbx: bnq qsm cxp fjr
vgz: fsk mqr jsh bzf
mhg: zps sgb cpm vhl stk hhd drl
rpl: zhs fhh lwg
mbb: qmv qrr
kpw: qmx
rws: cnz zls trf tjb pkm
hbh: tdf psj
nct: xwk fmp dgn xwl vkj jls vpl
nrx: sjw kwc pjr psp tqr bsf
wzb: xgc bnk glz
zrq: qkx xxs
qfn: bnj xsg wns qmd lhl kqq xnr nct wxs
cmk: bgw dsx cps ksb
hkm: zls rws klf qxt vrn
pln: tzd qwt
cfr: kmd nnn bvj
gbz: dtf flq sgb tfr
xwd: zhr pzx wxr pwg qcx
rjw: fpk blf jnh
kbh: dmw brq zbj lzh jfh qkk vgd nfw
vbz: pzb qrh vqj mff mcc
pgt: ljg
bwz: cjx mhx hhx wbp pzf
qfl: xmn hwf bzx
gmj: qrk tqm xdp lbr wpk pms nrg
ldc: ltw mmt lxq vlv bzr tsf
hxq: gcz lnk dlr czh
dtl: kwb hmt gxr vdq zhb wcq
lqc: sdf gxd kdr tgw nfx thb pxc wxg
qzz: nwk qhn gsb nwn
xdb: htv vwn fvr xqh jkw fmz xzd jxg
crv: dxg hpn
zjl: fbf nnk mzx lmt
zpc: jrw xzr zhr
kwc: nrx jmd wvv hzs hbq
gjb: bqr vwk fjw wwv bgp
cjt: qjz zfw pqd dpk
rkh: cjq hqm wjf
trf: gdn vbq wcx nlq prv
grr: lgt cqz jfc fhl
qdt: brw dcr
xzr: zpc rgx
brh: cwf qpc prx bbj xvt
jgc: jrn ppc fjv
qlk: gcb mvg nnd jhc lzn pln brk qcx
fvr: xdb hzw mrf qmp wth nxv mdb qwm zhs pbj
ccp: brw xcz zkj lkk zwb sqc
dbs: vrd xnh tnx zfd
fbj: pdr lhz mrv
snr: wwr rzc knt bgp xxk jdk
nph: hpk vft pcj xrv ppv
fvn: vnz bhl vnp pxc
jbp: ggc vkj zzt
qnz: pkm spx ppc
lgb: bfx kjh jnt msx qxn kbz gst dlz
rqp: rcm gvn msx xwd vgd smq szq jgc vmb
hrd: rgl zxs xmj wwh
vdb: bhl rdd vtx lpx wdj
hrm: bjw cxl mmf pvr bpk prz tjw bsf ltx rfm sbx
xnp: ddw rzm rgb xff xsr hbb
pjr: lcn cmw rln frb rvg jbj qjc
lxq: sct qdw
xkv: zxd rjx hln wwf kmt vqj lld
ptw: csn hhx dws pph lns
llp: kmd jvq mxj scv tnx pwb
gsl: wxr nvc ckg gmd jnh
bzk: zgv wpf hln qzm ldb
bnq: kxz tpr nts wcl hbx vxg
fjz: wpl tvr khr jbv qbj prz mvn dpk sbv
wdf: vxd jrq
dlb: ngs ntv tqt
pxv: sgr gzx cvc rfz hlf kvh kjn
qjr: swn hww xvw
ghn: blj vtx mjf xdp
jjx: zfk rgv lbj lfq vnm hfl pcz zxd xvk
bhl: vdb fvn kbq xxq sbt mqs pfx fsh
mjb: dbc wts
rpt: vdq
lfm: tvl qhz qnn
sbd: jls
qmp: wwn hnz
gts: dvw nfh lzh clj khn mwg
brk: xmn vwh mcg mhk
cfp: wcq grn qkx
cwr: qrr gsb cvc chx bbt nkm xdw ztk vsp
fdr: svw clp bqw qtd ppv
gdq: vdv
rfh: wlt zdz tsr pzf rzw
vjz: ftk
vxl: jjm xsj vmv kms nmn qmd hpg
trs: vvm tsf nzx gzx
jrn: jgc jkr sml ppn qgn
lnk: rlt
gcc: cdz xzq vxp gcb fgd kdh
kgv: vhr lfq dbc swh
xtg: mxz xxx gzx mrk xqc hvn kdx
lhf: pvr jkv ndf vvk qcz qck
kbf: tct kdx lbg drv mxf zkm vgq dbj ztb
pgm: xvk bhb rrm nsq pjb rph bzx
vcl: qbf kxr twt lgx fxd mcg whp qzx
xlw: khk fkz shj wts
snw: hlz nmn
xtj: rqc bsf khr nzz qqt qnq
zls: khs
nln: tkv jmb kgn dtf bvt
vwn: qdd fhq bsp fdb
blf: nkw
gxc: tnz tsk clj
mkp: zmw qnz nnj
mjl: prl
tjm: vdv lpx kpc frb wtx
xmq: rgq psp bmg
bnk: wzb sqc ddq hss
jng: zwj mmz lhl
gjg: mfh tnt nfq
lbs: jhx pcq qbr
kgm: wwr gvz twh vmh tfp lnk
ncm: rgm kjx kpw gqb flx mqs tpl
jsh: ggg nwz vgz
tqc: fnv hnm
mfl: vgs tsj jls rrm lmq rgh pzx
mxx: qhz wms xjc
hhd: lkv frb kml wrp sxw pgl
dmj: sct dmg hlc hzc swt ptz vqz jfz scz hdx
jdc: hgr mmt chx rsd
kzt: mcc zgv hbh rgv
htc: bfv gsl lvn bnf pfc bhb gss fht
wxx: xhm rwj xxk kvv
dlk: rlt trf xlp hvc ldk
zxn: qwm mmq nzj kgn gsb
scz: bcz tvr wqj xxq hfc scv swt dmj
zgn: jtw nvr hdx mvn
jcz: tnz zwx pfc wpv wns fjr whp mcg
sbw: bck sdd xhd vrq kxr
nlr: bwd bss fgd tjb
qzx: zfq vcl bcp wpq
bsq: hjd vhr nnd rsr smq mbv xbq pdq
wpl: wjn fjz vhl xzd kjr nld wms glj hmm kxt
pnb: llq mgr xxs xgm
lpg: zwn rjx wxr blh fnv pfq cql bxn scw hkm mdn
fjv: jvn gjj jgc zwj
tsn: tqw mwz vzq fwn
jjj: whr pvr
zbp: rgm rzw kcc
htv: bcz xzt zvd xdb sjh
tgw: tsl zqx
vsg: sgn kgv vgs
wwn: qjz qmp
sjh: wjn rtj zss htv
qnv: klp cck sct mwz qqz wzn wqz stv jhq xdp qxp ppz qpw
mvw: qzp tsz ksx fbd mxj
lhl: ttv sgn fll rhg
pcz: wps jjx lrk fpk
clx: vwr qts
qkk: pxf snw jdl jmc cqw jng
gsg: qbg xvq ttd vrn
tbc: xgp cfp tpl nwn lwq ghg fmm zmq
jpx: ppm
kjx: kqb sww dch prl crw lbr
sql: gkx
wxs: prd jpb mbs sqf vvn qfn fll
bkb: cql clj jzd xwl
bfh: vhr mjr hmp zwk drr
hnz: pqd qmp cgv dfh dmg jsh
qrz: wxb bfd xbt
pfq: bct rkg gvz
zbq: mjj jrg twr knh mnn drr rgb
zdx: jkg xkh
xsr: rkd
qrw: knq bgk vgc dzq mbb dxc zkh
nhh: hbk rkd pdq ffl
ths: tjm vhd fqs tvp kpc qpc vsp ffs
wjn: sjh vnp dqd wbt
ftc: khx xwv
jhq: vpv gxr rxr
pjb: pgm kls kvv mkp lvn vsg fwk
gxt: lpx gsn lzg tjv
smh: jcx gbx wwt
ctm: lzg qfc rfz sdf
nkj: dxb kpc wkr kqb jmf cfd brp
tbq: whp wsq
dtm: wms prx
zdq: mrf wrt tqq znx sbm
jls: zzp nrl sbd zrt khs
dtn: kwf skb wps fpk
cck: gzk
knb: qhz zhp znp vvv twk
vbg: xnl ztg pwp gtn hvr
hbb: ljl nfh rgv xnp lkz bxw tjb vnf jjw
qwt: hxl xjl pln wxr kgv
prw: brp drv
qcz: pfx jmx kgn fsh vzv
zhh: pqh zdz blj
sgl: zmw ksb pgt pzb kwq bdg fvh hbx
dqd: cnk ssl hsc vqz sbt
hcg: qhh
hwz: gzx skk
swt: pft nwn srd nzx nfd xrv
vxp: bmh kzm wdq fmj jbp jjw
nzc: khx qjz
tbt: vvm pzt dbw
lzg: ctm
zsk: jhc flt xvr
fct: wns tdm ksb ngb spx
dhv: pzt cfd zvd znx rzx
wdj: bzf fmw vlv vdb
lhr: flx wxg ntv
xvq: ljg jmw frw gsg
xjc: kpr wbx
hqm: xbq scw wdw wfj
wpz: lsr jnt ldn
brw: ccp bzk qdt ljl gcz wwv hbh ldn jng
shz: srm xzr fmj
hdx: qhn sht svs
kfx: qhn znp jdm
sht: klh lpw cxd pqj
rfg: plv wqv
mkc: gbp ggl jhk wwv kfb clj
gbx: mhb cnd smh tjb bnf shj
cfb: ggc vln
xcz: zqm hds snp
rdx: hwq bmg wwn cmw mbb srg bgd pdz dch qht
sgr: zhp znd pwb xgr pcn pqd
xfm: hrg rth tng hdw
vwv: jqq hvr rvv zls sqq
ktq: tlf ddw
mrl: wgd
kvh: pxv mnb
ssk: nfx xqh nhx nnn jgs kqv
ndz: zgm kqb rfk ljh crs lrt
qgz: qft mjl dwf
pmt: bgd rts glj nns xxq khx
tvr: sgr ggg fjz stv fsk lns wrp
jdl: qcf qkk xhd
rpg: pcr nwb zjb ftn zqx kmq
pft: swt qtd tcp zdz vgz nkc mgr
rjv: hdq pbm gvb
kpc: tjm tvp
mxk: drv hlf prz zvt
bfd: qrz lwp khr wpk sjl lcn
jmh: hxl nhv
cqm: kdj bth vmd
hzc: dwb xwn lkw mzb lfm hsj jvw hjw gff
gsb: vxj vpp
jhx: rcm dsx lbs dnd bdb rkd rgb
vvh: jkt swn rfm kth nkc tff
dnd: sgn xsz jhx mkf
glj: wpl
tcp: vxc lkn lbl vft xpl kvx
zbs: xjl rcm mff rgh gdc
vmv: rkg mnm dcg vlt jhk
zdz: zhh lwg sww rfh
vgs: rlp vwv sxk vsg xmj tch
rfv: pbv jkf dnd rtv
njf: hqw
zvn: qfl tmw tgv lxz cql wwt knh fxd xzq scs qlz
jmp: vpp pdx
stk: nfq vjr vtl brh pqf brp mhg
kmq: sbg ljh vcn mqw rlj
zcf: tmj dxm qrh
fht: vbg htc nfh dxn hkr
ljw: gdc pxh hqw sml wmt bnp
wqv: hnm rfg blf dxm bdb vlr tsk wlp sbl
xjw: dcr jrw mxh gss rhd glz
pgn: zwq mdn
pbp: hjw cgv zlb gjq xqc
gdh: vrq fqd
rwf: bnf nsh hqm jhc ppn
thc: lwg zdw vvk pns nrg
ppm: jpx hlh wqj rfh vzv dbs
qfj: zdw tsl rkf wwn
zrr: brv wms tvb ppz bsp
mkf: xlp sbl gxc zqg mnt
qgf: snp rkr rjb
pzk: rjv kdh cbm hdw pzx njd
mjj: zbq qwv
kll: gkj rbm prt xwk
zqm: rzc ckb qkv lkz xcz tbq dvz
nrm: pdr pkm tqc cdc rgx kjp
txn: wqj nkc hwz prl nfd wxq cnh pnb pph btg
hrr: bsp fvn kjr
kbq: xks rnm nns
tvb: qkb jzz hzs
wfd: wrg lxz vtm sjg
vlv: wdj dxr ldc dch
qrk: hgl lbl
rsd: jdc sql pns
fsh: qcz bhl tlv ptp
bnj: sjj nrl
rfm: hwz nwk bld lbl
frt: zhb zjq prz nnk
nns: pmt szt fmw qtd bqw kbq
rsl: knf lmn cmk sbl zqw
bwg: twm mgr mxz hqz nnr ncm mmq vvm lbl bsc slj
njd: pzk hfq khs
lkb: ntv wcq
njb: mvf hbx gvz wcx gjj kms
vwk: dbp gjb nkw
kbz: tfs cjz gwx hpg pzw lgb xmn ttr zfw njf rrm
hwf: lqz wkn qfl wrg rgx zbt xgc kcd khv
mvr: xdw nld lgt
kjz: gtn whp qfw vgd qlp kqq
brp: nkj zhh ktr fnx lkp prw vtl vzk gff pnt tff
nxd: hpn
fwn: zkh tsn twm fxm
pmp: qdk bdg pdr bhm brk wdq wdw
pvk: lwp tct msl jmb jkg nwz
tgv: dqw rgl zgl ldw
zmj: vjx krv ppj
hvv: vph kfb vqb xff zhr nrl cfz hdq rph rkh gfx ttr ddq
nwz: tsr pdx jsh
fnv: qdt sdd jkf gwx tqc lxl ldk pdk
lhq: fvw jtw mhx tbt sjp wzn hsj nhx
kfr: hgr nzj hpk bqw xzd jdc kpr lbl ksd nbw
hpk: mwz cpm kfr vzv
zmc: mkp nkw srm xnl szq kjz xwg cmk xmt hqt
ldw: qkz tgv bhm sbd
rjx: fmj cfb lpg xvr bgw gvn
tjg: qpt lkz bwk rrm trf crv xbq
lzn: mbv zrt pkj rfp pdr
xqs: bgd
rgx: hwf xzr dvw
lxd: qfw rcm xsr bct jwt lcz ddq mff
qlz: lqx xsl pkj rbm ncx
kmt: xqz hpp mmz lxv gbp xpx klw
dbp: dnm wwt vwk
ttx: prx rxr
kcc: lwp mjn ctq zmj hmq
jfz: dmj tsz qdw
gdn: smh kqq trf hvr sbw
vvk: rzf lfx lhf thc
rln: zrg mqr ppv pjr fvn
fmm: slj pdd pgl vqz pwb
bzf: wrr vgz qgd fqw
fsk: mqd pns qqb tcf srg dcz vgz
rmd: gfx
lmn: rsl sxk bfx
kls: lmw
hdw: shj twq xfm
vkv: ftn kcm tmn vdh
smb: zgv qbr zwk jvn hlj
xdw: flx cwr jxg mvr fqs gxr
tsl: rdd tgw zfd
qgn: sqq jrn
knh: chh
nrl: sqc hvv jls
bgf: lrk kjm
dkc: dbg hss gdc ckb bxn
cpm: nhg kcm pkb hpk
zxj: fbd kfs rlj lwl
ptz: tbt nns gdq lxr znd dvm
tpp: khv xfr smh nhh wdw
nbw: cgk flx xzt
xdp: zss vgc qnv jwh hzs ghn
knq: stv zxc qrw dfh zrh
xpl: dbj fvw fdr tjm
vzv: nxv ppq ppm qcz zrh wth lkb hpk
ttv: bsx lhl fpj
ttd: mxh vwv hlj gsg
pms: gmj klp lzq pfx
hkd: pqf wbx swn kfx tgw xqc chx zss
cmw: pjr wqj lpt
hwh: pdd mxf vkv
zdw: prw lbz thc xrv qfj drl
crw: kjx xvw rfz jkw
jdm: ktr kfx rql bsc klh
jxd: tmz rdv pqj
vbj: qwp wrr fhl njg nvr btq
ntv: bfd lkb cgx dlb wtx
bch: jkg vxj
ppj: zmj qjc jfz xgr ksd qdw rqc
rlj: qmx ztk
qmd: sqf rfp xgc vxl pmv mrv dlz qfn fzz
vwh: kgl rph
rzc: mnn smq
fcx: xch wwn ndf klh
mxf: pwc vft hwh tgw xzd
vtm: wfd lkz smn
vft: ggg nph bmg
mnt: xxk vrq xlw hvs nsh qzx mkf
lqb: pkj hzn hrb jrw cfz rkg nvq
dxm: fmj nxd zcf nsb bfh
twn: wql wrp bpk vpm tnx
tfp: jrk lxz jhc bck rkd
mxz: xtg tqw
cql: zvn vdt tbf tsj bkb
htb: shj gvg bdt cmk fll gdh dzs rfv
rkr: sqc qfl qgf hrd xgc lgx
rmj: klp hwq bmv htk npc vcn
btd: gkx qzz ppz wrr vxj vgh mdb
znx: dhv
rlt: zqw lnk dlk
mgc: nhg lfx dtf ngs xnh hnl dxf
ddw: tbf vbg xnp gst fzm tqc ppc qfw ktq rlx
mtc: gdd cjs vpm rxr sgb qqm
vvj: mbs nnd snp zls hvr dxs zsv
ckh: rql pfp txc ppq tsn fgs spt srd zsr vqz
pjw: hpg
jkt: kdr mjf tff vkv
pgk: pdl qnq qgz qzp nhx fhq
xvw: pdd txc
njj: khk zkj bfk jmh lbb qnp
mzx: bwc kjn
pvm: hqw cgp rzv bzx gxc kbm kcd
ggg: qdd vft lbz jsh fmm
rgq: vrb zmm xqh mjl jvq xmq dtm
lgx: zvm mqt qbg mlt vcl nmn pgn
zqg: mkf ngx hnm
gpp: ksd vnp jmd ggb
skb: ggd vnm knf wwv rtv rsl qcx dtn
hmp: khs bnj mdn
vrn: xhd hkm gvz
wns: fct pdb xmn
vvm: bwg fgs tbt znx xgr clp trs vnz
bdt: mrv htb
dxs: vwj jng
jjm: vkg vxs rlw xhb vxl vhr
pmv: qmd zfk xqz rgh prv kjm ncx
hzq: pmg bmj wlp nfw bdg zwx
dpk: rlm klh fjz
dqm: jlh xnl bnj bdt mjr dnm pxh
gkx: btd nkg xch sql tqq
nxv: zhs kth vzv
dxf: wxt npc mgc qjc rts
wxk: dsf jlh jmc pdq jrn fjr dmw knf
txm: ktr lgt fhl
sqq: grj pgn qgn
sjw: ghg nrx
xsg: qsm gtn bmq rbt dwr nkw ncx hss
bkm: jbj hzw mhx
gxd: qqb jkv vjx shk tjw
qgg: sqf nlq bfc gdh
szq: zmc rqp qlw
clq: bgh bhb kwq
qwm: btt rln zxn ghm nzc fwn
jxg: bmv lcn cfr
zpx: zjb crr ctq zql
wcq: wql cfp lkb
xbt: qrz zmq gqb ddv kwc zvt nkj
jdk: bwd ldb
mrv: rmd sdd qmd rlt fjw fbj bdt tns wsf
lmw: ttm xwd kls kcg dnm bzx
jgs: vsp
rjb: lnm pdk rkg qgf jdl gst zqm ghs zwb
dbc: cnz qlw kgv sqq mjb hqw qlz
vxd: dvl fjr twt bth plv hpp vvg wdf
vnm: tdm skb wwf gdc cfm jjx
rlm: nxr pwb snh dnf dpk
fjr: vxd vxs hbx wpt jzd bmj
kdn: twn vrp cfd xmq wbp kfl pdz
spt: lbz bpk
gdd: jvq ptw lrt rww mtc pdl kkp srt pjr brh
vgh: mmf czm bzr gxd
hbq: qqm hlh szt hwh bbt fvw kwc bld cxd bwz
jzd: pbv gjj jrk fjr bkb vqb
sfg: nnk jhq qxp
zfk: wwt mdn klf nxd pmv
gst: ddw nmn zqw
tnx: llp qhz dbs
tdm: qkv vnm bkb gcc rhg
ztk: cwr
flq: frt nzr xjc qjc fbd gbz
mjr: dqm
wxg: nfx fbd
qqz: zss mrn wpk vrb
qkz: hds pgt nsq cfm ldw sdk pwp xjl tsk
dvw: hfl lqx
zkj: qbg hbk
pxc: cdg rtj lqc fvn
hrg: qgg nvq ngb xfm wxx nhv
zlv: bcp hpp zgs mjb fmj
nzx: trs jfz bzr vdh khx twm nkc
zmw: tjk fvh
sgb: zmh vpp tqt mhg mtc
zgv: hbf qdk smb zfq bzk smh
mqw: lfx sql tcz
vzl: wdq rlx gcz
smn: wgd vph mrl vtm ckp dlz
dwb: hfc hzc
qtd: hlc lkb
mxh: ttd vwh jhc mvx kbm
zjb: lxq zpx krv rpg
wwf: xmn dwr
pmz: vrb bwz nvh
qxn: brq wts
hxh: mbl rbt gss nxd fxd bfx
hdz: cmw dbh hqz nvh gjq gxr bld drl
spx: fct qnz bnj jnh
tdf: pzb ckb xhm hbh mff
lmq: fll zbj
mdb: tvp fqw
mvp: sdd
qln: lkz wpq svg xhb
kwf: dtn fvv vxg njf gcv
ljg: twt xvq jnt twq
lld: mlt sml
nfd: ghm swt
cjz: xnl lmq lgb
xmt: kkk rlw mqt bmq gts kms skb bxb
llq: tzr pnb
zql: zhp hmt
qsm: bth pzb qkv khh hbx xsg zkl
nvh: tjm srd dxk
mbs: wxs bgf
bvj: xgm lhr psd pmz cfr twm cqz
jhk: sdd bst vmv
ntk: gll bkm cdf kqv cgv qck
ttr: hvv hcl llz pdb vlt cbc kbz
vvg: grj vwb pnk hxq
cxp: zrt gvb hbx szq ckb bdt cfb nqw
tcf: dtf wrr mxv ffs
pjn: vbq rtv pdq sbd
kdx: kbf xtg
rvr: ldb jvn wwt mcc mmz ljl pxf mbv
cgv: hnz zkh pbp
wrr: vbj tcf fbf
qht: rdx ttx sgg vgz
cdc: kdj ghs gcb mjr
jpk: qjz sbv bmg
tnt: bgk rtk lpw glj jgs qzz gjg
jzz: tvb sfb vcm rsd lmt
lxr: xzt hdf cdf
lxv: xpg kxz vvn smq vwk
tqt: dtm bwc lpx
hmt: kvx rmb vnb zql prx xtk
clj: lcz vqb fzm gxc
hds: xcz xsr dsf fpj hwl
pfh: xtk jkv hsr rhj gxd twk
ttm: fzz qkk zxd ljg lmw svg jlh
rzx: mrn dpk qzf
njg: sbx qkx vhd cnh cpv
ppv: kdr blj fdr bbt
fsg: hdx shk nns vzq nzc
fvw: lhq
dvl: hvs xnr vxd rjv wpv khv hqt
hqw: pvm xqz zfq ljw njf vrm crv psj
bsf: zfd rvg xtj vzq wrh nrx xln hrm
hcl: wdw ttr xhm
qhn: kfx rtr cnw hdx qzz pcr dbs
tqq: xtg vnb cxd zdw zrr qrz zdq sgg
gms: hgl kvx rkf gzk
lgt: ldc tqq mrk txm hww mvr grr lzg jkt
dnm: zkl dbp gvg hwl scs xzq
pdx: dcj jmp wqz nwz ftc tjw
zrh: drl znp kvh xls
mwg: nfw
hlz: jvn snw qwv hfq xnl dcr
xhb: jjm qln
tjb: hbb gcv twq
hlh: xxs
hkh: qmx nhg
rts: hdg pmt nnk dxf
bgd: mqw hjw rdx xqs pbj psd mrn qmv pmt
fll: mfl mbv lhl lsr wxs mvf lmq gkj
wrt: shk vhd wbp hvn zdq
lbg: kbf zmm hfc bsc wvv
cgk: bzt ctr sdf vvb nbw
tqw: wbt chm tsn
xxk: mnt
rvd: cps bfc hzn fvv lbs hlz qgf
ppn: xqz rwf jrn rhd kdj cfm
wwh: hrd rfg zlv sml pdr zzv hvc
blj: chx ppv ghn tqr zhh htv cnk
nhx: pgk ssk hlf
jfg: sjh mmf rsd tqm xgm zqx
pqj: jxd ftn tqt sht
xmj: xwl hrd vgs bvr
whp: bxk bwk kjz tbq vcl
mmf: vgh hrm
vpl: fqd lkk tsk hfl
nnk: ngs rts sfg vdq
pdr: wdq fbj
dsx: dvw cmk xmj jhx jsw
sjl: svw
hzw: bkm mvn fvr
qhh: hcg tsn sfc xgm hmt tfr cck dbw
rcm: rqp ntq
psp: tjv
ftk: cbg xqn vjz
fkz: rdh pzw wps zbj xlw
jjw: grd tch vxp ddq
ksx: fzw
hzn: lqb lmn wjf
rhj: dnf ksx kpr xgp pfh
xzt: xch xxs lxr trs htv
mcl: ffl svg qbf
qkx: zrq wlt
dbj: wrp nnk kbf xpl ztk
mnn: kjp qzm dlz rzc zbq
ppz: btd glj pqz
lpx: gxt pfp tjm tqt
jmb: pvk rtb
zfq: zgv ntq qzx
lkn: ctr tcp
qxp: mrn rpt sfg tbb
xqh: xdb
gjq: glj zhb pdl hdz txc pbp hkh cck bvt dmg mtc
nht: bfc qql xpg lbj mvp nvq
bgk: fhh tnt qrr rtl zdx zhs
klf: rkd
rlc: sbt dzq nkm hrr
skk: hgg qfc ffs hwz wrt zhp
dvm: jmx dxc
lkv: sgr lzq vgp mgg srg hhd pcr qqz zrq
xwg: zsk swh srm
zjq: rqc mtc mhx lhr nkm
swn: kpc qjr
vgp: xzs mdl btq
rhg: ccd kcd
rth: jpb fjw xfm dnm cqm wxx ccp mxp lrk
sct: nnr lxq fhd tcz fbs xkh vdh
lcz: clj dgn qql mqt
prl: mjl jbv
mnm: wdq qpv bwd vmv czh
fxd: hxh kbl
vvb: xgr cgk
nzz: pcn rql kpr qnn xtj
hqz: hdz wtx
ggl: pnk vcf mkc hmp nnj
gjv: bxw vzx fvv zgl mjr lqz nkw
nrq: pjw hxl cbm
bxb: shz kwq jmw mjr pxh cbm
vtx: cjs mhx xpl vcn xlk ghn xgp
kzh: tbf nxs
wxt: rfz nld lpt
tps: cdz kzm
blh: zls wrg jrf xff lpg
vdh: sbm
zsv: ngx wpf qzm qzd
rdd: rdf vgh tsl
btq: vgp
hdg: kfn jmf
pnt: brp qrz hkd kfn wtx kfs sgg
pgl: rzw fmm
nzj: vhd zxn dxk tjw chn hgg krv mwz
kmd: llp dbw cjx gll sbt mvr qqb cfr
khv: lzv tpp lqx qcf dsx
glz: bth zrt
dcj: pkb ljh pdx sdv kxt ptz
khj: ltx klc stv hwh mrn
jkg: tsz zdx mrf prx bch pms
hdq: bdb vqj rjv psh nsk csd wjf
khs: zgs lqn fgd njd wdf rsl jvn gst zls jls hmp
tjv: hfc psp fqs fxm lkb
vvv: nkm khr knb hhx npc
txc: gjq gpp hzw xmq xvw dnf ffs
vqj: xkv qql dcr
qpt: snw xhd qnz
zqw: rsl rlt
wms: wpl zgm dzt
ftn: rpg pqj vkv rzf sbg
zgs: zlv vcf zhr wkn
kvx: fwn dvm gms zkh dnf tcp
brv: pzt qzf sbg
xpx: zwx
rxr: cxl fdb ttx dtm jhq
ctq: qjz vxc nkm tsf czm rdx lzg vdb psd lbr zpx kcc vgq
pdz: kgn rfk jkv chn qml
dxr: xmd vlv zrg xwn
xsl: qlz bxk wjf ldk
bcp: ggc mqt gpl
zhp: skk wrr xnh qml zql knb tlv
vcn: vtx
mgg: spl vzq mdl lns rtr
khn: xwk bfv kcg
kqq: gwx
vlr: ckk
bsg: wfj hvs pmp lbb xqz zkj crv lzh xbq dcg
jtw: hlc kdb zgn bzt xmd
vrd: qrr crs dbs sgg nrg
xjs: dxn ddq bxn kls
prv: qwv zqg
cgx: mxx lcn
ztg: lqn jgl vvg gwf vbg jnt
qzt: qmn ntq
rsq: tzd zzp cjz dcr frj trb
tsr: zkm drl tqj nwz
xtk: hmt pcj hnl lfx
cfm: qkz lwd rwj ppn
xpg: sml pcq nht zwb lxv
qwp: gpg ctm scv pgl
jmf: nqr hdg gzk cgg szt nkj
zjn: sxw kdb jgs rfh fzf rdf jpk hwq rlc fnx
qrh: cpx tch mlt zcf
xnh: vqx dbs pfp pdd
svw: drv spz zmm mqw sjl fdr xvt mzf bzr jpx
lns: zsr ptw hdg nqs
npc: rmj twk
vmb: wpv jvb zxs
kxr: hpt cbm vlt
qlp: kjz gwx
kft: zrt bgp kzm sgn bnp vgs jdl cgp nlr
dws: qgd
khk: mbv njj vln vrq bnp xlw sjj
rmb: hsr hmt
nfw: mwg wts bvr hzq rtc
kdj: xnp zvm ppn cdc nmn cqm
zvv: nnj klw srm hjd
hnp: srd cwf wbx mjl hlc
rgb: ngb zbq qpv
mcc: vbz zln nnp xjl
dms: xln grn znd
sdv: dcj pkb mqs
ldb: jdk qlr ctv bzk
pwt: tlv rtb brh ths ssk nrg
wqj: txn ppm dbh
hfl: rlw mmz vwj vpl dvw
mjf: dzt mxx
bdg: vlr hzq jwt pmp sjj snw
wpk: qqz ftc kfl kml
kgn: nln zxn sgg
nnr: znd tvl shg sjw
fhq: pmz ctm nln vwn xjc qpc dlb
gvg: zmp htb
mfh: qqb psp lzg
wcx: zfr trf qxt
rfz: pxv rdf qfj ppv wxt ctm crw hkh
cnz: wfj csd rzv rws qgn
xkh: zdx hbq qfj vtx vxj vdb rlc zmh gpd flx sct
jmw: gpl spn xvq zwq bxb
bmh: sxk zwq wps fmp
hxl: clx qwt nrq jmh mmz pzk vcf
pxf: twr qkk rvr
fmp: bmh mjj glz vvn tdr
nld: mvr kwb
kbm: mxh
bxk: bgh xsl tnz
xfb: ddv ptp jsm shx
jrk: tfp rtc dkc jzd tnz
btg: zhk cvc jwh
pbm: bbw tmj qnp
mhx: rfk
tnz: mbl qpv scw bxk gxc bfv vwb hfq jrk jcz
jvb: dqw zxt vmb jrg jlh mxp
nrs: xqc pqd rzw
jfc: spz lpw jkw hjw bjw nqs srg grr
vph: hvv kbl
gqb: zmh zrq
kzm: hzn tsj tps bfv vxp
nmn: snw vxl gst lqz
nnn: kqv mxv
kkk: ckk pxh rbm mlt
wbv: hvc wpv hln nqk
lbj: jjx qwt rlw nht jvm
qqm: pfp sfg chn
vjr: stk nnn fmw tnx nwk
hwq: bsc zjn svs
bmg: jpk vft
tct: tqm chn vhl kbf
cnh: vpp pdl cmw
xlk: vtx
dwr: ngx wwf vqb lmn bsx
fhd: mgr mrf prx znp gms
nkc: vvh whr wmc lpt
qkb: wvv nhx szt thc tvb ggz
frw: lrk prd hqw rrm hfl xvq bmq
vbq: smq cbj
kwd: shx fbs hpk grr btt mkz
gwx: qlp fnv kqq bnk ngx
hzv: jkw qxl
dxc: rww qrw
fgs: vvm hww
gpd: dwf cnk lbr xkh lxq
wvv: kwc qkb lbg
jkv: gxd
ksb: sgl xhb
bmj: qzd smq rmd fjr xpx
dlr: cgl bfx qfw sbd zln tsj
ggb: gpp pph hwz fzf shk hmm
kqv: ntk pbb ssk hgw
ddq: jjw bnk xjs mbs
clb: fdr hlh crs jbv sfc vdh
knf: qkv fvv wxk
zmq: vgp vtl mcw gpd
cps: xbq vrn lzn cmk
fwk: pjb pjw
hsc: grn brv zzk snh xrv dqd
npm: lfx thb xlk crs wbt jwh bmg stw
ktr: txm jdm brp vvk qmv czm
nfh: frj xdf ckk
wps: ckk dtn fkz tsk pcz fht hmb bmh rrm
nsq: qzt zcf qnp qkz njq jkr swh pbv ldn
xks: mxf wbx sfb thb kbq
zmp: shz rbf gvg ckp wbv cbg xxk smb
wrh: vvb lbg xxx qzp tmn
nsv: fbs qnq
khr: vvv xtj
rlw: lbj
lbz: cjs spt jfz qxl qmx
zcb: qbf qcf
ffs: qfc
pdb: qql
dbh: vxc kdx wqj sdv
vdt: cqt dmw dbp tfs lxv mrl cql
zsr: zdq zrh dtm sgg lns ckh pcb
cwf: qds jmf qht hnp mxj brh
bwc: tpl cvd
bgr: fhh gjg bbj hmq fhq srt vdv
wdq: vzl mnm vxg pdr vxp lnm
zhk: mcw flx dch btg
wsd: prt lqn mlt
zwx: xpx hzq fvh mxh klw gjj
gsn: dtf ndz gxt jmx ztk kjx clb
sbx: pdd qpc thb njg ctr rfk hrm klh
sml: ljw wwh
fmz: tmz hcg vpm ttx
qbr: pdb fbj lzv
kdb: cnk kml wmc
mvx: tfs xsr fqd
wxq: sfb nhx qxl lxr vgq fdb
pmg: xqn prt jfh rvv xvq zwk qcx xsl hzq
wrp: twn bld nfd dbj hhd
qpc: brh ngs fhq
cvc: btg pxv vdv cjx pbj gzg zxc jkg
vcf: hpt qlr hxl
