ssb: kfr zbj xrd
dzc: nmh jdc czd drz nxq
ggd: gzp hgw xlm hdb ltk kph scj
wgj: pwz sjw fmn bkf rfg
vfm: xsm rxv dtn bxh rcs zwz pgh skf jrc
jxx: pdx rrg sfr mwf vcm hwl mnk xmh gvz
fvs: fvp pbt czd fnm mbm wrl
lfx: sht vsj ppj lqk
dvj: zhl zvp vpz mlf
vdc: fpf cqh gpg rgb
dwd: ztw lfx rff gxz tdz wnc
pxv: mkn bkw spq
dfn: rhl
wzw: chf ldv
kfl: mnk ccc xbj lzb
rjf: dqj rmf pkb lrj ssb qsd
lkz: fns
fdp: fqm qgg fzv bmd
hzh: dzz cxq qlx bgr hqr
vld: whp lvg cbz
nxq: rcl dzc tsz
pcv: vqb jxr ppd
dws: bkp tnn gxf sgb dfg dsv cqx
hnr: shm pwt
xqg: gbk rql wxf mbx fjp nvl
pjf: qmc fwg knh dtp ckt lzp bgh zrb
png: wqx pnt bvs
pbj: vmf tjs txz
lcb: bcv tdb chf gfv mkj gtb fhm
xgx: rhx fwh
xft: xkz fxq ppx hzc xbg nvq
bbj: slb qhm sgs zbl
rbj: kfw vwh
nmg: jqk rjk
pzz: zjv vfr pdm npn trd mwd
zxs: sng rjs
nsf: jxg hpb qlw lqm nsb
drg: drc dzb xsx
rwn: gxz zmd gvr tjc sgb kdx pzn
pdx: cdh jxx fzj vdf phj sbm
dnh: bmv lzb sfr xbc
vwh: knh zqr rbj znw bqx dwz htf
tdr: jtl mjh vgv jdc pwr jxz dzs rlw
lnk: zql vrz fbc fbn hqr
hqh: qbp vkq vpc xmf bdt xqz twf msw
gmm: wcr svm vnz tnz hfj mpw
mxt: crv xwq sjw dtk
gfg: mgh dxk svk wcr
srb: fzc nmw ldn wmq hnl fsf bmw
tvp: ztv fpg ftq jdd vlt fpt gcw
cht: wlv qzs kxq
qln: zmg nhq cjz vmx hnr dhq bqz
hfb: qrn nrl jzd
hfj: bfv lbv cch cqh
khj: xpl jkz
pxj: vgq bct dbb fsc vst nfc bqq
dbf: qrl fnh mcn mwx lbv whm rpf nnm
jjz: kgv gzv snp rrn
bxk: llx nxq mbn
wfz: lzc
rmj: hpq jfk jfl rrg xxn
jlp: rqr mmp xdr rzt
pwz: nbq wgj rzw
glf: mvx ssj
rrl: vfn kdx wlj szw fjc fbc
xls: scg
msb: vlt shg cfb qrc
wzp: wlv cwq mwf gmm dtj ffl psp
pjg: jmv hmx frj
bkz: cjk jkh xqz slb nrl rfs
wbp: hgz vdm
fwg: pjf hxw dxb sxr lht
kss: bmv dqg lnz
fzv: tkj wgw
xrf: jzm gvs
pgd: tzf tfk qbp sjx
qdk: wtj rjg
znw: ckn vwh qtj
bbk: rpw sww jxr jzw
vqs: dbr xqz nvl lkz zkk xgd dss fbz nkc
xbx: hxw clg cdf hbb
wxz: twf clb wmq
wqx: rdk snp wgc kdx
tms: drt btq sgt bzp
dlr: wvz tlc jpk bbr bdt mfb bnk lrf
qzp: sdm kjt jqs csn
ssp: rzk
djk: hdc bmn dss
gsg: xtf
swd: jpn bct
xgd: clp kmr kkm vqs
zks: xvp wng gdf mcn
mwf: jxx
bxh: xjj rfr qpz gwn jqd
bql: kbc
qgw: kpb
njs: ssr lbf jtg hvz zvd sll zsd
nlf: fcq lnm krb rpw
zbq: rrh bsw hwx rbz nkc gpv vdc
nck: vgr bhg nsb vlt ghc
zjt: vmw llx kxq fgx
hzc: xft pqx kcx
hkk: zdf ttl nrm ddh rgj cnm dbp csn
kbr: rwn mqj gcn jjh swd
sjw: qpz mkz wfz
hwx: rnc chf cqh
bjv: rbc shz qgg htf wmm wtq kqt dkf qvd rsq kcc
qhj: mzv mwx qlb xbm nlj tzc dmn qgj
kdw: rfb vnc krn rcl zvd mfg sjx vdf vdd
zcs: lht
qwd: dtk cmg
lzk: kqg ktb vzl xlp kdp mtj wpw
vpz: dvj
fbz: hfz
xhm: vvc pbw qwd rfr vzk
wlz: ngl gcw xdd jpm bkk
vzd: wtq cfj pfh
gbk: pcm kqh zsd zrh gcs gjs whp wjg xqg
ljf: fmn wst dld zlh zmd mnv pcx rcs rzw
hbt: hzn
dzs: bdm wfm tdr
khc: hjk zxg jzd wcp fjp
knh: zbj dgz ttl rjx vwh
zhk: kkn dzz mtr vsk
cbn: zln whv vnp fzv
vjj: kqz zjv dtn kjd
bhl: gfd drz
bbs: xkz
ncs: ddc lsf ktl
cnk: kwn qkc mtj
xcq: zmg qnv jfs blq cmm
whl: rcb kmr vvx hbr
dff: pwf nmw blr
nqq: hvb rkv nxq sgn nlm
pdg: mkg mxm swk mmb
pch: bnd ckv kjk mzn
bqt: mff ptw vmx
ckd: qbg wcs
bbh: qgb wst xrb ztv
sbp: lnz zmg bnr
ngl: tnh xnf lkp wlz mkz
hgx: lgb fdz zsl dmz znt jbh brb
shz: zbz pch dtk szd dbm
znl: ldv
rdk: cvb lgr mnv fml btp nrt wqx wrv
ljv: ksb lbp zjx lzc zdh
bfv: mmb vnb qnt plj
sng: zxs ncq ddz qmd kjk gvf vnt bdr trd
bdr: bsq mrl znr ppj xjj
lqd: vbq cqk jbk
fmn: xst dmj dld
fjc: msm rrl gtz
qkf: chc
hrn: svm kbc
hft: rrm pjj mzj qtm ptw
lsh: dkk nhv msn jqs
rjg: btr njx
mbg: sll pnx vqq bzp wqs dqg cch xmp
hgc: mtm wfm bkz ljs zrs ppd zjw
clm: wxp cwc kph bfv zsc sgt
sjc: wgc lmc zqr
pfw: lrv bws lzw jrc kgf zlc
gpg: qbg sbp jgw
xbm: mcn bdz chd qcg
kxr: wwb fgs
stt: kmn xcs ppx
nnd: mwl kld hdb lnm
hds: tvd
sbz: xjw tbd djl lsx cnp zdf
mwj: nvq hpb
llv: smg bkz fbv vmx whm ddp gsd nqq wkx dtt ldv dnx
dlj: vpr nkp pqt
vrm: mzj btq xrf bbj phs kmb
gkm: rqm crd rcz vkp jjh
tbd: dtk mld kqt
xpl: hnh qbb wjn khj vcr zzj cnm
dtn: gqc gwn
zrh: frd tbm prd wdb dxw vjg bbz cdm
xvd: clg mkl xlq xhk qcm sdr
sxs: vnq plc hdk mtr
dzb: nkl pnl
mkj: hmf gcl qzz
bbr: hsk wgq
kxd: lhx
nww: fhr btx pjj zbt
zjv: txg vjj dxb xbt
dss: fbp djk crq
stf: qzs
rsl: bkv hbb fjc
xlp: lzk pcx bsq
rkk: jmr lkx wpx kfn
pgj: pjk bnp wmm tjb jtb
rmq: ckn wxt rmf
vfr: nqx ktb
hrr: kfn gdc gdq hxn zzj
shn: jmr btg zrb zbb
tkj: jjz qws dwz mwj fhw fzv pwm
bjt: xbx zqt rjx sjc btg bvd jbw
sdm: xcx vnp
nvl: vqs xqg
krb: vzq kjv nlf vkq
kxk: gsg zwn rrv bbs rgz qpz znf vkp
gvf: qsw hqd sbl tsx qcm
hbb: xtf ckn rsl xnr xbx
szw: kfn rrl rgm zvg
dtk: shz svs qwd
sll: njs zpx wcl
bvj: krl nkq cnm lfx txz fhw
qjz: dvz qwj css vwb
ktl: bxz
tsz: nxq zqd
hbz: rzg lkg plt dff mbm jzw cjd tkq
mtr: frj zhk sgb tfs
gkf: vwb pjh xnz
gtf: xgn kfw fpg hbt fmc bkf
cdn: nbp ztk
xbj: dnx kfl nqk wvz bbr vqn
ptb: ffz gfn qrn brn cmm
gfc: cls hpl szf
hrc: wzz lbf nrl tnz
snq: xmh cvv gzp nfg hkb
ppj: xfd zqt pgh xdj psq bdr
mcs: jzj zqn hpw gjn ztw wtm
vdm: vkq qrn
wzc: htf jkz sgg cnx
szd: shz pkb pwm
hmf: slb fch mkj wfb
qnw: zrb nrg jbk
smj: gcl cwm qjp cqh prd mnn drt
wcp: xpg nzz stf
qnv: mwt
kph: zdd xkh clm skl
hkb: snq gfc krn csd gbm mmt
vnc: kxd hwl mpw hpl
nws: shm jng psp mbn
kfk: qxt hcp qkc cmg qjl gmw
lcs: tnn flt dtk
zrc: skv rzk css jlm rfp whl
bvs: jkw dcr djl png btr pqx
kgv: hhk jjz dhv
sxw: szz bjn bgm cvx dvz mfg rvt pvm
vcr: xpl rfr mvx kdx
dqm: zsp msn lsx hdt
njp: ltb ntj mgn
bcv: nkl mmp
jkz: jrl khj wzc kmp qlw
cmd: ccc wfb mkg ntm
xmp: vdk zwx rhl wht qzs mbg wng
nfg: wcl snq hfj whp
vdf: mjh pdx kdw
pnr: fhm hft kbn bnx vzb dzh ffz
rds: xff rrh brn xlw qjd
jbh: gpc pqx nbd
lsx: sbz flt dqm qcm wtv
vlj: nbd ttk qff zzj
zwn: kxk rjg
qzz: mkj jkh
qgz: gjj dnm
kxq: zjt
ffz: sjl fwh gfv ptb pnr mmp bqz
dxj: xjv vmw mkp
pnx: gpm hsk lkr
plj: bfv
wpx: bmh kjb rkk dkk
jrg: lxl qkc xjj rjg rsq tbq
nks: zbb crz ljm
dtj: fsf lnz qmt
zfz: whv lqk
wfm: hgc szz dzs xwl
fnm: rcf pkj
pbt: fvs crl hww vpz cjz
fjp: vdd khc
gsm: gvs nvh kjv gcl jzd
hdc: wmv djk ltb qzz shm
hjk: tph khc hdl klh
wjp: gjg knh lbw cfb vwt nxz pzn mrn
cqk: lqd tmt
fcv: fvr cpx
wtb: kfn btr
ncq: fvn rdt nxv sng
bnb: khn bhl sgn znl
pwg: xrb khj scd
dxb: kfr fwg vbq
qbg: vwb lwn gpg ckd xsx cmp vzb
jqd: zfw
lqm: fwx fhz
rhx: qjd hwl xgx qlb phn jsf
jrc: btp pfw hzc rzh
jrq: nsb skf
lbp: txg xvm
zsc: ntm rfp wng clm kqh
bkv: whv rsl bnc xhk hkk rrn mzz
cdf: dwz sdk
bjn: vwb lbz fff mxm nrq
pnt: fdz png kxl lzw chs
jlm: zrc jxr
txk: zzj lrr tvd bvj lnb bcx nvq kcx vsj
fvn: ptp rcz cnb nqp pgj xvd xhm ncq
hnn: qcb
kqh: gbk bmv bwb pnb zsc cdv gvz
lsg: cqh bzr vqn whp wcs sjh gbm xrm
fhw: bvj btp tkj jzv
vqb: bxp pcv nkp
tnh: tsx zdf
hdx: rcb hnl stf
gsf: nln zkv ntj
wzz: hrc htq tcz pdq pxv ntb
gfd: hwh bdt nfq kgr bhl fzc
rsc: zjf kqg sxz lvk jmr dkk lsh ttl rxv xsm
xlw: jzm kmb nhq jzc cxj rds
xfs: wgc
srr: pfs gvr zvg nkb fjv gjd zdh
qsd: gng qgg
vnz: gmm wvz
lnz: kqh hgc dtj zwx kss sbp szf
tbq: qlw hpw
ddh: tnn bvp gzv
shh: vrm ckd rql bqt tzc
tsb: nxs dtk wxl lpj
zzr: rfv znw hjp bgd
mcx: shl tcz brk mfg tms hrn
skv: mpw tnf gbm zrc zgf
vkv: ffl nzz
ldn: kjv srb gbt rkv
qws: tdw lht rfr
vhq: dhx vqv
kpq: kdp stl zbj xnr scp ftn
xrr: wwb vhq ntj cxs
wbv: mqj sfq ttl
qck: wrp wws tvd dnm vrz
bct: swd dkf bfx
kws: ptt zkq shk dgz
lml: gcs bnr bql
xbg: shk dvm
tfk: rbz hfj kbn vmw xbj wxz zvs bbk wsq pgd vmx
dtt: llv rzk mnk
tdl: cjz kxr zgh dhq bcn
nkp: dlj vqb
jvz: wsc xmx fhr
gkx: gmm ljs lkg zgf sgn qbp jgw
rfv: hgl hnn znd cqk
sjl: smg psp
nhv: vkf qcm lsh wjn ftq qkc btm gjg qrf
pml: wpw kfd
hhm: dlm qlv zkv nhq rdn ckd
mcl: fhz btr
tjb: zjj vjj pwm knr
hzn: hbt mvq
cww: xbc dnx
ztw: dwd hmz
cxs: btq xnh vkq ttm zkx bbk vmw xrr
lbv: cxn
dmb: pxw wbv nrg gxg
dhv: xtf kgv
rjs: kmn
lrf: hrc mfb qwj flr nzz ngz mkn mtm
pgv: bkf
drt: tms qrl skl tkx xnh mgh mqz vzq
vpc: zcc hqh
hww: fnh mzm
lht: gwn mvq qws zcs
zmd: vlj vnv rfv hgl
krp: mwx sqm wsq bwk
hfs: fpf rgb mrw lrn mbg hgc jzw
fdf: ckn jbt sdr
hdj: btg
mkl: mrl hvx
mnv: rdk nfb nqf
kfd: qfg pml gcn hqv xdd pkb sgw
gqq: mzm smz ngp thj plv gpm
bxb: vrz wzc lhm mzn mzz
lvl: bvj cqx jbz vnv glf
vqv: prd vhq dvt mmb jgw jlx fpf
ppd: pcv mgc lrc
rgj: hnh sqt hkk rmf xdj ssj
fvr: fcv zvn xwk sgt phn tfk jlx jzf
pgh: pxw zln
qhh: mmh
xtx: flr tkx jdq zxf lgt nkc rdn tdl
dqn: flg ppj ggc gll vzk qrf dtp kdp
kcs: zfw jfg vlt kjd wbv
pzw: qjd gmb vwl czd scj rkx
vgv: jlj tdr pjh
xlm: szx jqj jfl gcl mjh zkk xbc nbj
kbf: xmh bmn mbx qgw
tzf: fhr jzc tdb sjx bnx pgd
sxz: kcj pbj rsc lkx vwt mlq ggc
ttm: dnx bgf hkw
mmz: gxg lmc jtb ddx
lmc: twz sjc ssj qwd
ptt: wlt qwd kws
tgn: hgx dmj vgr wlj lbx
sgb: kkl rwn fbd dws gtz
ldv: znl vcm wzw htz dzh mfb wfm
jmr: rkk wtq pqx ngl shn gsg
czz: nlz nvl brk hnj
mwt: hwx xwk jhh qnv
bdm: jng cdv gvs rvt dzs rcl zqd
gzv: rvs
tnz: pjj mhq hrc
cpt: clg lzv rqm
hfm: bsp qzw rxv wws rbj
wqs: mbg gfv ldv bmw fgs whm qrn
jlj: ldt vgv rkw wrm qtm
xmj: dzh spq pgl khd
pvm: gfv sdh
wtq: vzd qxm zlh ptp lrv mnv qvd
bcb: mgc dvr ntm fbr nmw
htn: pcv xff njp
pdf: znt dmz fqm qrf wxl
pkj: ksd fnm
nrl: khn hfb bkz vvx hrc
bck: nrt lpj fwx
mld: tbd mtj hdj
fxq: qrw xfs wrv lgr txp dcg pmc
xvz: mwx vrq hwh
szt: tlq jfw
nwt: phs lkr nlz wbp rkf
sqt: wpx rgj hlk ztk kfn xsk
mwx: khn krp xvz qhj rjm
wpf: ncs ksd fkz nhq mlj sgn
fhd: pnl kbj wjg rpw qzs
xsx: bvv qbg drg
mmn: nfb gdq zjj mhm hlk
rzg: jnj svk hbz
rzk: zrc ssp nzz
bcn: gvz scf tdl dqg
rmf: rgj wrc brj rjf rmq fmc
lgt: xtx
ttt: npx wfb rmj vwl fcq lkq znl
lkq: mmj slb hvb lsd
zmc: cpt wql jdg zdh xdd
qmc: jtb pjk pjf znd
kmr: xgd pgl whl rzf
jbz: fjf vst
mlj: wpf fbp
wcl: wlm vqq sll
tph: bgm mwf bxp fbr hjk xxp bxk ksg gbm
cmp: fqv cwl
lqz: mmf swk dxk
bsq: xlp khv gxg dsv jrq rcz ltq zbg
nbq: sjg pwz ggp xfd zjj
nxz: wjp sdk dtp hqv kws mtr
cbz: gkh vld bjd pbt dlm pkj jrd
zrs: wcs lfj mqz clb zbt
pgl: kmr bwk xmj
fbv: llv zbl wsq rfp ckz
zjj: mmn lzp fhw tjb
xpc: sdh wlm bgf vdd
bnx: hkw pnr nfq
qsw: bdc xkz fbc
kqt: cxq bjl
fpf: kph krp xqz vgv vqv zvn dss jgw vdc
vcq: gpk qcg mgn qbg fvp msh xvp bfv jlj gsm jfs kbf
qbp: tnf prb hqh pgd dmn zqq
kfw: rqm gtf qtj shk rbj
wcn: lqk jzv zhr jrl
hdb: xrf nnd bhl
rfs: rld sdh
wtn: znf qdk krl qtj
gpc: jbh xgn
hld: hsz fqz pnb cvx
hhk: nkb kgv mcm gdc cfj
crq: lhw gdf cdv
wrm: zgh fmm jlj qmt xcw stf hkb pnx zsd
kjd: crd
zkk: hsk
hvh: wtt lqx kmb chw gmb tzf pdg flb rjm
mlq: rqx hvx lwt
vpr: fcv qwj mkg zzl
hjh: tvd hcp bvp hrl jtv xrd pkb mhm
rdt: zrb fhz dvm rmf btl
jln: pxk fch cxj pwd wkx sgn xcq gfn
bnd: psv qcb djq
zvn: rdl
wwv: xcp fdf vzk cqp fpg gcn
khd: rbz vzq
qgb: zlc kkl swq vwh bbh
zbl: wcx rgb krn
sdk: cdf
gmw: zsp wcc vtr
rfg: zpf bzz
jpn: xrb rnw pbj ljm gww sqk swd pdr
sdr: rkd bwm
fhm: vwb mmh pjj wrg lcb pnr lbv whm dhq gkf
whm: lxh
gwh: rsq kgv lwt
zbz: mrl
tsx: nkr fmc tnh pkn psv clg
cfj: hhk scp gjj
xcm: lvk gqc svs hmw
mnk: dtt jhh
msh: fzc gpm zkv vcq jkt rfp hwh wcx pkj sjx
sjg: nbq qlx lsx kmw msn ksb jtc
hpq: rmj fqz zmg fsg xmh dxw tbm
fff: htq
qxx: xkm phs jfx bhk cvx
mzz: zlh bfx bgr djq
svs: cnm dtk xlp swq xcm pcx bgd
dvm: rdt nvr fdv xbg jrl
blq: wxz xcq mjh jzd djk gvs nvh
kjv: xnh ldn gsm htq
htf: gwp bjv wzc
rpw: fhd rdl bbk gsm zkx ktl nlf
btq: vrm tms cxs zpv
gdf: zks crq gsm xqg bsw
gvs: bdm xrf
zql: qpz wcn lnk
lxr: bgf tnf lnm mzj dcs ccc rcp
rnc: cwm hwx rdn
xrm: mfg rrm fts zxg plv
dbm: rnw khj shz lzv ljm xqb
dbw: lqk zlh
vjr: hkw xmf cwl rpf dxj rcb kqh
qlw: jkz kkl
cmm: dmn swl phj nfk bnr
qrc: gsg znd
btp: jbt fhw mbr
lgb: tdw tjs hgx zlh zbz ttk
csd: cdm hkb
xsm: vfm lpk ksw rsc fbd jww ltq nsx fsc
vdk: jzm rnc nfq rdj kgr prd
lxx: tdb wlc jds qgw
xsk: bkp kqg bbs sqt jtc qbf dkk
spf: ztw zbj rrn tvh zwn rzh hqr
jpm: qcb fhz xfs wlz vrz
sgs: rrx bbj mgn dbz lhx jqj xcw
knr: lgq jfw
gtz: wrv sgb fjc lgq
bxp: vqb
cqh: zgh wsj vbf lsg hwx
lth: frs knr dtp qlw jrl
fsj: sdk qrw zqt gjk kjb
hdt: nks rwn dqm clg kcc ztk
mlf: lqx sqm
zwz: ckn khj
mff: cht fcq bqt spq ldt
frs: lrj ffk lth qjl sbz hqv dcg
fbn: cjn
rhl: dfn hsk qjp
lvg: vld dzb tdb bwb jxz wpk
bbz: jng xwl fsf
lmh: wpw tvh ppx dkf jtc gjw
rsq: qqk gwh qkf bjv hds jrg gjj
lcm: xcp btm
hsk: bbr qmt zkk pnx htq rdj hrn pjj rhl
vrz: hbt lkp rjx qck lnk kgf djl kcf bxb jpm qxt
bvp: kjb xqb ddh
gsd: llv wsq
nkb: cxq whv wtn srr bvr kqg nkq jfg
ljs: zkx hgc
fvp: vcq pwd fvs mbn
zqd: tsz cxj
dkk: wpx lsh xdj
shl: mcx hml lkg nrq kqh bzp
cdh: gcs jnj
xdj: bxb ppj xgn dkk jfj
gvz: mmh jxx bcn flr kqh qgj xxp
cmg: kfk qwd
ckv: dtp jbk qpv
kld: czz zvd nnd kcb srm
nmh: kqh dzc ddc vkq cww hpl cjz ggd fcq
wkx: jln smz nfk dlm
mxm: cwm cwl
rcz: gkm qcb jvj
zqn: fbn mzn ztw mcs
bkw: svz jwr fns
vmf: pbj xst
rrp: mzg lrc tnf hst gzp dfn fgs hmf
cch: tnz hfj srm
frd: gdf gcl lxh zrh rzg
jxz: kvz ssr fnm
wmm: bjv pbj pgj
spl: fjc tzk fjv wxl
jbw: bjt zcv ntc nrg fmn rgz
pwt: zgh gdw hjk srm hnr rcb xrf
bwc: dll bvd cxq fbd fdz
lrv: scp nks nqx mkz pfw
pfs: fjk bck vfn kfr
hmz: ggp ztw lpj qfg kdt
tdw: qws pwm ngf zmc sqr lgb lzp dhv
tvd: hjh txk qck
hmx: dtp
hgl: sdd kjt sgg
gll: lgq mcl
hmw: gcw
rqm: gbr kfw mxt pgv zdf cpt
skl: gcs
brn: kpb cvx qcg ptb rds
pnb: hld mbm bgm kgr gkf
znr: ccn qwd nwd bdr
jfx: qxx vsv njr vmx xvz chf
qjd: pzw kbj cht rhx dfn rzt rds
gfn: kxq krp gcs
jkw: bvs zln
bgh: cfb stl lbx zdh
tzk: ghd rmq cwf spl nvr whh dld
fjf: gsg hmg nvq ffk dqj jbz
xvm: hzh flt kfj wqx lbp shg msm zql
gxg: mmz dmb
rrx: hfz rcf tcz crh wwb qrn
nfb: ngq mmn xlp hdk whv mnv fmc
rzh: spf
kkl: qgb qlw
mtm: lrf clp dmn
vsv: jfx wlv jrd
wtv: lfq dbp lsx
clb: kcb wxz bkw clp ssp nkp
rkf: nwt jds dvr qfj hfj
zsp: nqx fdp ksw fsk gmw znw dqm vfr
bnk: wcs
prd: vdk zrh vqv smj
jvj: hdk mtj rcz vgr
ddc: nmh wrg klh xtk ncs
flg: cxb
vmn: zbj jdg png cqp vst
kqg: gcn bnp xsk rsc
pbw: zlc xhm tjb fbd lpk ppx ddv whv fjk
brb: trh vfn hpb rzw qcb hgx gll jvj
xkz: bbs qsw rsl rkt kxk xft
mmp: ltb kvz bcv jlp nkp ktl
tzb: hbt xft fjf bbh pzd dcg bzh xlq
qbf: cnb fhz vtr
fkz: wpf kqh zkt zwx jrd gtb rqr kfl crh mcf
ksd: pkj nqh zpx ldn tnf nnm fvs wpf vrq rql
xnw: vnt kcj vtr kmw txg
sdh: rfs xpc
rdl: mkg csd dxk zvn jdq rpw
drz: pcm bhl swk
zlc: kgv hvx frj png nqr
mrw: hml mff zrh
jzf: fvr sds gfg xld nlf pvm xmj ncp
pdr: pjk chc rkt xvd
vxl: crh zvp scj qvx ptw
fnh: hww jlm thj nws phn nmw qbp
zjw: brk
dcc: gjf ssr xjv
gbr: rqm ncq
qxt: vrz zbg stl
mzj: lxr kgh fzj mfg psp
cvk: ttk jdd
rzt: zkt jlx hdx jlp wbp wmv
hvm: spl flg shg kfr qkf
mcn: zks
tdz: zln dwd djl csn mtr lzw lbp rfg swd jtc
wlt: cxb ttk
xnh: ntj dtj pcm cxs kjv wcs
nkq: bvj pcx
lvk: cvk kdp rtw rzh kgv bwc xcm kfd
rkd: mld ggc sht rvs wql gkm cxb sdr
xdd: lmc gkm xnw qvd crz psj wlz
wpw: kjb pml
ktb: jbk lzk rgm
pfh: xhk bzh vzd crp rtw cqk kjk rgm
bdc: bfx ljm pkb qsw kws nzq ghc qsd btp
nvb: qjd mtm kxr plt
nrq: shl fns
qtm: mmf bxk nqk gcs
slr: dlj tsz vwl fgs xwl dbg
dhq: fhm qln xgx tdl cwc
xhk: bkv qkf hqv
bpl: dnm qqk gcn nkr qmd hjp wst brj dtf qzp sgw ncq njx mkz zqt
gwn: xcs dtn lht
ppn: sqk zfw
fwh: ffz mkp
xjw: szt sbz
fgs: wqs hvz rrp kxr
vcm: jxx kjv bjd pxv
qjp: rhl gpk chw rdh rjk vdd wtt vxl smj
cjn: hxw jzv zkq djq gvf fbn hrl kfj
qxl: phs lkr qbp jtl gsf svz
rjk: bmw
mzg: ksg gqr ssr qgj bwk vzq brk ntj rrp
pdq: mmf pnl ptw wzz blq
cwm: gjs nwf mxm
qrf: pdf cdl jzv
sww: bbk xlf mzv wlc qhm
tzc: qcv bcn sdh rfs
skj: zfz rzw dqj nhv nqp mwd hqv gbh jtv sht rxm
wrg: ddc jhh hfb fhm vbp
qkm: wtm jbw lrx tsb sxs fbc djl jqs nqr
dsv: bsq btl
gdw: zxg gfd pwt
mtk: mmn lqk kxl kpq dbb xbt
sds: mlj mmb cjk mbx wzw jvz bql
zlh: lgb qmd mzz dbw
ftq: nhv zwz msm zcs vsk
pwf: htz hhd hgc nql scc dff jkh htn bff sbm vbf
bmw: srb rjk ckz jzw
lxh: whp rwf fwh whm
wpk: lkg zgf
xcs: wmx xrb chc stt gwn lsx
nwf: dzs cwm gpg mlz kcb
sgg: wzc cdn
lzc: jdg wfz pjg
bhg: nqx
djl: tdz nvr hbt vrz zwz lrj
pzn: bhg nqf wjp dmz
xmh: jxx snq
kcc: hmg wzc pkn xlq
fdz: bwc hgx pnt gjk dfg jpj tdn hqv
ccc: scg lxr cmd zzt
bmn: vmw bwk kbf
bnr: qgj wfb sbp
hfz: xkh dcs fbz khn rrx zzl
scg: mlf ccc rzt xxn snq kgh xls qxx
qvd: ghd msn kxl xdd
cdm: mnn vzb csd rhl
kgr: svz bqk pnb gfd
jpk: lbz dlr rjm
cwq: mlf
hdk: jvj hgl ztv nfb
jbt: gcw fdf sgw btp ttl
psv: bnd fdv tsx hvn sqr tlq
mzm: nlj fhr xmf dfl drg hww xrz nfg wcx gfv gqq wcr gfg hvb
xlq: xvd mnv tzb
rnw: qxm dbm gwp ttk xvd jpn
kkm: lrn sqm cwq mnn xgd
bsp: bzh jjh mvq
cmz: wlt jbk pdm gdq wjt
mzn: bxb zqn bnd pch
npn: jqs tjs
wgc: pzd xfs sjc wqx vlj vcr ltq gvr xbg xst crd
rdh: gcs hst bxp sbm lsf nfq bxz
whp: nfg vld dlj hld lxh bgm
bqx: qkc zjx dmz zpf
lrr: ntc htf szt
vvc: vgq ccn cnp wcn
wlc: dnx bhk lxx kxr
bzp: szz twf shl tms
rql: ntb mwx ksd mnn vkq fgx nln
kjk: zqt pfh sng
vwl: slr pzw lkr szx
qxm: clg fml wtq
rcf: rrx fnm
xnr: hbb kpq sgw lcm
zkt: fbp rjm
jxg: vfn
hvn: psv qcb cvk gqc sgw
bcx: ghc txk txp
wgq: krn xdr
flr: gpv xtx zcc lrf
pmc: lzv crp dmj mwj sqr fxq hpb xcs
srm: pwt
ptw: lhx
cjz: nmh tdl pkj
nnm: lgt mlz fmm
fgr: lxx bxp ccc lhx plm xqg
dgk: vnq wfz khv jqs vgr vzk lqm ppn
bkk: pxw pjk mtk nkq wlz gwn ttv dnm mcm lwt
wxt: rmq dtf qpv bwc zwc dld
hvz: pqt bvv fgs nmw
pwr: tdr xmp htz cwq qhf fmx ntj
wxp: gmm vld wxx xld wsc dtt
sgw: hvn shk kfd
xgl: hbr nfv wtk
jng: jrj
nlj: mzm shh
chf: rjm wsc lcb zkx tnz hwx wzw
hwh: mkp xvz gfd wcl vdd
jld: rcp kxq hpl
nvr: hcp mhm dvm
thj: sqm gqq
gcn: bpl mvx kfd kqg
bjd: ffl vkv bjn
rlw: xhc gsd fgs msw
gpv: flr zbq cls nlf
vnq: sxs qlx dgk zvg ghd
tzl: krn wfb zgf tqc rdr wht
fml: rdk ggp ksw
zbg: tlq bsq
qvx: dxw ddp bdk
jfj: skf gbh jqd
lwn: bgf qbg
qrl: dbf pkj jds
vgr: tgn dgk msm xbg ngl cqp nck mcs jvj
qww: bqq fdv krj zxs
xcp: lcm zjf
tjc: npn nsb jdg rwn hqd bcx
rkt: xkz msb zkq pdr txg gjj gdq lbp
zbw: pjk qnw rcn xnf
spq: mff gtb
kbc: zpx dvr plj hrn bql hgz
cxj: klh
qnt: vqq wlv
gpm: rwf lxx msh
zpp: nfv whr bmn smg ssr
lcd: gqr rkb jlx
nlm: mgh jld xld cmp nqq drz lgt
gvr: dqx rwn
tdb: bdk dvz cpx gmm rqr lxx
wng: bff
pwd: vbt jln
xjv: mmj pcm cdh dcc plj dxj
jtv: ppn lxl dll bdl nrm trh tdn mcm znt whh
zqt: jrd nvr kjk fsj
vnp: gtz xqb gmw
jzc: spq xlw mgc gdw tzf
mkp: kbj hwh fwh
wmv: jdc nwf xxn hdc rzt dlj khn nqh llx tqc
htq: xmf wzz jtg hsk chf fff kjv
css: qjz gzp
qgj: bnr pxk gvz
hnj: vqn
bwb: kqh pcv lsd vpz
skf: bdl
rdr: btq xnz wlv
fzc: lfj
fpt: tvp nqp hdk wrp qzp zwz pgh jdd glf
fmx: pwr smz msw qvx hhm pwd
rkx: pzw hww stf zpp pjh zhl mmt
gqr: dqg lcd wcp xkm nhq tzf
pcx: rff svs
sjx: pgd
jww: hnn
hgw: ggd pvm vqq nkl pgl
tfs: vkf lpj qww mtr
zbb: msm nks lnb zqr shn
gbb: rkb kvz qcv nvh ptq
msn: lsh sjg wtv pqx btl
qsg: btl nwd zcv crz ddv bnp
rbc: rxm stt cqp twz rrl dzz gbr pdf
lfq: bct xfd wtv
ksg: bff gsm tqc nvh bcn
xhc: zjt dnh bdz hst jfq
vqn: swk plm bzr hnj cxj
fwx: wmm lqm shk hvm sxr whv ntc bck
pft: mbg lhw sbm gdf jvz vdf
mgh: wcr qnv nlm gfg
wcs: gzp ckd lsg
rjm: zkt jpk chf
gjn: txp hvm fsk dqx mcs fdv jbh lrv
gfp: fhl xnw znr gww
knj: vmw xsx tkx zkt pzw rkx
ntc: fwx gdc
qlv: qcv
fch: smz jln vdf
sqk: hxn chc jjh xfr ppn tjs sxh
cnm: hmx szw svs lbx xjj
rkv: jfs pnl
tqc: xwk wmv pqw
bvv: hvz pqw shl vvx xsx gmb
kvz: rnr mmp jxz whl
rtz: bvd nkq tsb ffk kgf xhk
rbz: tfk cvx khd qzz
lnb: txk hvm lfq zbb shz bgr
bhk: wlc zjw
ztv: tvp hzn hdk njx khv bbh fjv cmz ggp
whh: rmq
hqr: ssj lnk cqk fhz msb tmt
qhf: dvt kss
fns: mmh bkw nrq
bzh: pfh bsp hmz crz znf tzb
mtj: stq ssj
qjl: frs wjt qdk
qgg: bjv qsd
bkp: gvr crd dws rbj flt xsk
jtc: gjd xsk tdz sjg
lwp: ckv fhl dwz xfr vgq
nqf: cdf pzn gbr mnv
hdl: mmb
nvq: txk xft
mvx: vcr wjn
hml: crh jhh mrw tdm shl rrh sfj
zxf: ptq xwl lkg blq rds
gbh: sfq hpd
nbj: xlm nzz
ggp: bkh fml kfr mkl
ntm: crq zsc jfk
vnb: fzc plj bfv
tdn: fdz bcx
btg: bjt hdj ghd
gxf: pwm dws lgq
wjg: gbt qhm
zpf: rfg bqx pwz fmc lzp xlq
lqx: cjd plm mlf hvh
crr: cqx mnq zsl glf jdz xlq vsk chs zfw
wlv: vbf nql
nxs: crv dzz xst bvp tsb gjj wlp qmc qbf
pbh: tbc scd txz tkx dtp
gcw: dmz hmw
rfb: ldt mmt rcf
mqj: zwc ddh
vsj: lfx txk mhm
rvt: fgx xls
jpj: vlt bmd fdz hpw vtr sqr wtv qsg cvb jdz
npx: mwf krb wpk knj mmb ttt gkh
scj: dkh lhx pzw ptw
cpx: lfj bqz fcv tdb hdl bzr xvp
dqg: dhx bcn twf qlv kss nzz
rcs: vfm lsh ljf whh
dbp: hkk kcs lnk kqz wtv ccn
dmj: kjb cqp mbr fmn
mrl: chc mkl wgw vsk tmt zbz vsj gqc
wrl: nnm nrq pcv wlm bjd fvs swl
gzp: rrp jlj ggd css nqh ssp fqz zpv snq wcs vjg
lnm: pqw nnd hzb
klh: mkn cxj hjk vnb
rfp: rmm zkx fbv
qhm: ltb wjg
cnx: wzc lqk zbg
tnf: qfj rrp skv qbp
nbp: bgd nxv pzd cdn hrl zzj
scf: pzw hvb lwn bcn cvv nvh bcv vpz
ttl: rsc jbt hkk ddz bwm fbd knh wbv
kfj: lzw vkp jkw
lpk: pbw zql pdm fjv gpc zwc
ffk: rtz frs mwd dcg vmf fjf
btr: hxn bvs lwl wtb kcx jqs rjg jfw srr rvs psj mcl trd njx nkr
plt: hbz gpv zkt kbf nvb zpv
cdv: swl xld bdm
bjl: lpp pzd
lzp: mcl bck ltq xkv zpf
ccn: vvc znr crz qxm skf
mjh: xff vdf tdr szf
frh: qlb fff cjd
twf: rmm lbf wxz bzp
vzk: dqn rzv pjg gxg
jzd: xxp hfb zvd gsm khc blq
hqv: tbp nxz xhk kfd
qmt: wrm crq dtj jzc cww
hxn: lzv
bvd: bhg dcr pgv kcx
nwd: wmx
wjt: mcl fmc cmz jvj gjw qjl bvr kqh
sxh: qpv khv cmg rgz pjk hdt tgn
jkh: qzz bkz lsf fgx pwf bdk
wtj: kwn
xwk: hzb tqc mwt mkn jdq rld
cfb: wjp fdv cmg zfw
npm: zkv zqd zpv qzz bcb ddp sbm kgh rvt wsc
krn: zpp kdw zbl rkb wgq ncs hkb gbt
kgf: pfw pml vnp hbb rfr
tvh: lmh bdl spf zwz
pkb: hjh rjf kfd
vfn: pfs brb jxg
nkl: wlm tdr dzb dxj hgw bcv dvt nkp vsv
zgh: bql vbt vmx cqh qxx xrf pwt
nqp: nsx kmn fpt cnb krl rvs zhr
xtk: xgl bkw bdk vld zvn
dld: wxt sjc xcx fmn
qlx: bdl zcv cnp
hmg: stl lnk kcc tnn jfg msn
mmb: hdl sds hjk bfv pdg rzk
psj: xdd
kjb: dgz fsj ppn dmj wpx wpw zjj
xvp: fzj zks wsq tfk cpx jzw
nfk: hgz cmm
jtg: htq
pwm: dbw gxf tdw szd
qmd: sng bpl zlh shg
xmx: rzf fbr
lkx: trd gxg
zsd: dbr fwh njs lkr
twz: dxb tbq vnq lmc bjl kkn sqt
whr: zpp drz lgt
dgz: nrm
xnf: cnh
hkw: bqz cjk vjr bnx xff
cnp: qgg sbz vvc zjf qlx rrv qxt
rdj: vdk dzb bxp vkq vhq
fhz: rdt mcl
rrn: spf jtc jjz gtz dqx msn
lpp: jvj tbq tjb ppn pml rdt bjl cdl
lsd: nwf bwb zqq prd fff cdm nlj qfj dmn nfv
ffl: bql vkv ltk bjd
bgf: lxr nql lwn
bmh: znf msm qff
hcp: cxb kcx wlp zwn bgd nvr szd
hvx: mlq fbn mkl ghd fdf xkv
rrg: bqk
blr: vqq xkh zxg
dbg: zzt ttm fqz rjm rxq
jdc: pgd chd hnr
xwl: wfm
lqk: gpc zfz mtk vkp wcn qcm dbw
jxr: pcv gjf
sqr: mzz xnw
mbm: hbz rld sqm kbn pnb
qfg: hmz fjv dwz
kfr: ssb hvm gbr ggp gzv pfs lpp dxb
pdm: ztk pzz
dbb: pxj pzd bmh mtk
vjg: lvg gzp zrh jqk plt gkh
lhx: sgs xmj ptw bdz kxd plj lkz ckz
fqv: vbt fkv fzj cmp bff gfc skv
lbw: mbr vmf dbw bvr kfn
kpb: lbv brn qgw
wvx: ssj lrx jfg rgm
tkx: rqr nqh mlj
fpg: wwv ltq gtf wmx lxs
psp: wzp sbp
dzh: ldv pnr mfb
xrb: pdr bwm pwg sfq bbh llg xcs
kbj: pjj jsf mkp rzk
dbr: zsd sgt svk
zbj: knh hds ssb
fjk: pbw pfs mhm nkq rqx jmv
wxl: spl tsb scp
msm: znt ftq fjc bmh vnq
kgh: mzj mzv
wdx: rjs kbr qff qdk bxh gxf ggc tvh
kqz: btl xkv xst qzw
wsq: gsd
lwt: bkk gwh nrt jww
hvb: bhk lkq scf lqz mzm
lxs: qqk fpg njx
rgz: kxk sxh fml zqn
vkf: nhv cnh tfs
vbp: ktl bhl jqk xff
gbt: xnz krn dtt nql nfg tsz wjg fnm ldn
kmb: hvh mfb vrm
jrd: vsv zqt fkz
jqs: dgk wfz lsh npn fqm
btm: dtk lqd lcm tmt zbb nhv bbh
tbm: vqq tkq mbx
pqt: tdm hvz phj
lhw: bzr pft crq ckd
dbz: phs szf vpc
kcb: lqz lbz clb khc
fbp: dss mlj zkt xmh
rzw: ljf wlj
rcp: fvp lxr jld
trd: kcx lkx sng pzz jtb
gjf: bhl qhh dcc rzf rzt dmn xrz jxr njp
xlf: tqc xgd
ttv: bkk pfs wbv lmc rrv
vbt: bnk pwd krb ltk
sfr: jfq ltb
vgq: mvq zhk pxj vvc bdc nxv
qpv: sxh hpb zxs ckv
znf: wrv bzh vvc bmh
xkv: vsk bqq hvx
vsk: jbk xkv
rdn: szz crl
qcb: hvn bnd gjj brb hnn rcz
nln: vvx bgf gsf rql lbz mkg gbk lbf
cjd: pnx wgq lqx fts frh sds lhw pjh
jhh: jlx mwt mnk wrg
lkr: vwl
bwm: zwc sdr wnc ttl
fmm: nnm kbn xnz dkh vdd
wst: ljf hxw bbh
nbd: rzv jbh vlj rcn
lhm: sht qxt hmw hnh gll
wws: rmq hfm xcp qck wgj tzk bwc dbm btm brj
crh: nqh hwl rrx
vzq: fkv xkh mlz krb
kpp: fbr bmv rrg gdw xpc
zkx: chf ljs wxx rfp
bdl: skf sdm tvh qgz qlx tbp jtv
jmv: pgv jkw fjk lgr pjg rvs djq
msw: rlw mwf fmx znv
tlq: nvq rrn zbg szt ddz znd
txg: knr rkt zjv tbc lbp
sdd: wst hgl kfn
mfb: dxw gfv dzh
zzj: hrr txk
mqz: vmx zrs
zwc: mqj nfc lpk bwm wjn
mmt: fzc fsf hwl bzr rfb
ntb: ngp rql srm wzz ntj
crd: dcr kjd hqd qsw lcm
hsz: hld zvp nzz bqt zjw vnz
fhl: rmf zln gfp xjw qck scd jbz zsl
bqk: kgr gdw ptq pgd gtb rrg
xwq: mxt scp
stl: hmg qxt
hpd: lbp gbh wtb bbs
wcc: xnw cnh lxs gmw crv qzw qnw
zrb: qnw gtf dll kkn hzh rnw shn pjf qpz rdt
kcj: sxz ngq
qcv: jnj gbb qlv gtb tzc
gkh: btq vjg npx hnj
nrt: bck lwt sdr rdk kjd wzc
znv: ssr nqk htz msw
zvg: vnq
gjw: ksb txz qww zpf gpc wjt
chd: jdc qzs dvj xbm fff
kdt: qrw hmz
jdg: bxh bkp mwd vmn gxz zmc mvq tjc lzc mwj
llx: klh wkx rrm bxk zjt gsd
xcx: dld rfv zbz stl sdm
krl: nqp
dkh: pxk rqr dcs scj svk znl fmm
shk: kfw rrl kws lbw lfq xbg sgw fwx kcj
xtf: wtj hbb swq nqf gsg psj dhv vzd
jzw: hfs xvp bbk drt shl whr bmw rkw fqv hgw hbz
bvr: nkb
kmp: jrg rjs lrr wql jkz
chs: bfx lkx pnt pbh
jds: qrl
zhl: hpl sqm vgv ldn dcs dvj plm
plc: lwt wgw nqx hdk
zln: jkw cbn jqd pgh pkn
gng: msb gdc qsd mmn ftn sdd
nfq: vdk rdh gfd gpv bnx
whv: nfb qmd bkv ddz zfz
mwl: nnd vzb
vfg: xkh hvz
ptp: wtq dtk ptt jfw tkj
htz: pwr znv pwf fmx
ltb: sfr nnm njp qhm mmp mff hdc phn vpz
ngz: lrf nws tsz hdl
ksb: gjw
wrv: lxl qrw stt fxq gtz znf rqm
gjs: gbk nmg cwm jdq fhd bgm vkv
vzl: mcs hmx mld rtw dll nbq lzk qlx
fcq: mff nlf ttt
gqc: hvn dtn
sqm: szf wrl mlf xld whr thj fgn krp zhl zks
cvb: dcg zcs
dcg: frs lcs cvb ffk jqd fhw
lbf: hwx xdr twf
crp: pfh
bkh: ggp jxg hjp gmp dsv tjs
wrc: gng jrq llg rmf jdz
nvh: gbb blq khc
zzl: vpr
ftn: gng swd xfd kpq
bws: xfr zjx chc
hnh: xpl rgj
llg: xrb gvr dgz vmf
flt: lsx
fjv: spl lkp qfg lpk
txp: fxq
tlc: rlw dlr lcd kcb mcn lrn gmb
plm: zhl lqx csd fgr
vnt: xnw wmx kcj ngq kjk
tqm: bgr khj zfz ncq
xrz: gjf mzm thj vwl pxv
sht: rkd mmn jxg gbr lfx lhm jkw
bqz: cpx vpc hkw
vrq: fqv dfl cls xvz bgm crl
zdf: hkk
trh: ddx brb kdx crr jtv fbc hxw
cwl: vjr mxm qwj
cwc: dhq wmq mzv rvt ssp bnb wgq
rmm: fkv jrj rfp qnv vnz nlz twf
wql: zmc gww hdt qnw kjt
rxq: dcs hjk nkc bhk ngp
kcf: vkf lpk mrn sxr hdk nfc vrz rqm rjf lwl
pjh: rkx cjd gkf
vkq: hqh vdm
zcc: mmf bxk vdm vpc hfb dzc flr dhx
khn: nrl wtk bnb hfz dvz mwx zzl
qfj: wfb rkf sdh rzg tnf
wrp: dcr
lrc: ppd lbz fsg jhh
gbm: lsg xmf
cxq: hzh bnp kqt nkb
tnn: lcs hmg jxg ddh
mnq: ddz
dhx: zbt nfq gdw lzb vhq kpb
gcs: cdh skl bnb qtm rdh gfn css lml
mmh: wfm vbf gvz jqj fhm fns qhh rgb
txz: gjw bvj pbj xgn
vbq: zjv jzv hnh dxb pqx kmn lqd tnn
ngp: mzv lbz cvx rnr zsd gqq tcz fbz rxq ntb
lgq: gll mnq jjz knr gxf gtz
zkv: npm mwt tkq
lrn: hfs qhh tlc dhq zrc kkm vnz
dfg: dbp hnn hds xwq
qzs: stf wng
lzv: xtf cpt bzh rrv mtr vzd chs tsx dbm hxn
ntj: njp
lmr: wvz xrz scf cbz mlz qzs khn rlw
vmw: zjt gvz dxj jzm cxs bmn
jqj: xlm mmh jtg
rcl: kdw nxq
zsl: crr fhl
cwf: tzk ghd gjk whh lht pxj
tmt: btm
fdv: qww dvm cfb
tbp: bdl qfg kkn pdf cxb nzq
snp: wtm
crz: xdd nks qsg kjd nvr sbl
svz: qxl xsx bkw kgr zqd dvr
phn: ltb drc
ldt: szx jlj nwt rfb cwq mff pxk rrp
vbf: cqh sgn vdm mmh xsx lkr qrl wlv pwf
bgm: gmb whp pnb fbv
rnr: jld hnl lfj gkh clp kvz xgx pdg
rzf: kmr mzv rfs qgj xmx
jqk: wpf pnl dxk nmg xmf
pzd: bjl wlz nfc wtj nbp dbb
mkn: xwk klh btx pxv
wxf: rpf clp nrl
rff: pcx cfb rkk dwd ttv mzz
fkv: nmw vzq xls hst fqv
rqx: xbg mlq nsf fjk dld lqd dws xrb jbz
hpb: nsf mwj pmc jrq
jfg: wvx
rrm: pgl qbg btx qnt mpw bsw hft mqz
rgb: hfs zbl
scp: cfj xwq lrv jqs kpq wxl fqm
btx: mgn rrm
lwl: dqj kjb frj zpf kcf ktb cnx
bmv: drc kss vfg dnh kpp vqn
sfj: nfq hml sll crh ddc kfl szx
qcm: gvf
dll: jtv snp
pjj: hft kbj
zjf: xcp bqq jww rsc
jrl: wcn
gjk: cwf fsj qtj fdz xrd
lsf: rkb ncs rdh
btl: kqz qsg dsv msn
lbx: cth cnm lth zbg bqx
xfr: bws jrc hrl sqk gvf jmr kqz
wjn: xpl nhv mvx qkc hzn
mkg: clp pdg nln rdl
nqk: mgc wfb znv qtm zvn gpk
mmj: xkh xjv lkq bqk qmt
sjh: xcq jzd dbr ksd zvs ffz bxz clb pcv
bwk: mzg slb krp zjw hst bmn pgl
bnc: znt vst bkv
qkc: cnk jrg nnc wjn
jzm: vdk wsj
lkp: mkl fjv xfd qrw ngl whh
pnl: fhd jqk pdq dzb
svm: zvp lkg tdm kxd
mcf: xwl nmg nkl khd
xff: htn mjh hkw rds
gjd: srr scd jtc htf dhv
shg: qmd wpx msb
szx: ldt nzz vwl lwn
wwb: rrx zzl xrr xvp xhc rfs wlc gqr phj kxr lbz gdw
nhq: hhm
nqx: lrv bhg plc
mwd: vtr pzz ffk
sgt: zsd bdk tms dbr stf
ztk: kfw cdn pdm wjn gdc sqt
vmx: jfx bqt mqz zgh
gxz: rwn npn
pxk: ldt lkz hwl qmt qgj
djq: bnd jmv zhk ghc
dnm: rsl qgz khv qck bpl fsc
hlk: wnc
brk: mzg czz zjw
hqd: pwg jjh zkq tjc bkf
ghd: btg
cls: vdf wqs gfc gpv drg
ptq: zxf bqk
tdm: hnl nhq
hgz: zdd lnz wzw xtx kbc nfk zvd wbp
gdq: mmn wtb cmz hrl
xkh: vzq dzh csd hfz
jnj: smg rzg
xkm: pwd jpk hnr wdb
fmc: nfb rmf tsx kdt
rld: xnz xwk rfs mbm zhl wvz xwl
crv: wcc nxs kmw gxf hdj mxt
kcx: bvd vst hzc
dqx: ggt gvr
hst: rdh bwk mcn qlv
gdc: ntc ztk pcx
fts: cjd xlf ntm wtk svm qhm zkx psp
clg: hdt pml lqm cpt
kfn: hrr wtb szw
gcl: mkp frd mkj
csn: gjj hkk fwg rcn rgm qzp zxs mwd
ggc: kwn rkd bdc vnv dqn wdx sxz
szz: vqq wfm bzp rdn fbz dvj shm zzt
rkw: sjl jrj szz jlj frh
mlz: nbj qhh vzq
vwt: sxz rhr
dwz: stq qfg cdf rxm vwh
fbr: vwb kgh bcb xmx
fzj: pdx xvp fqv mzj wlv wcr jld
bxz: jdc ktl sjl jxr
kmn: vbq stt
scc: mgc bxp wmq
fhr: tzf mzm nww
dtf: fsj hpw bpl szd qrc krl
gmp: vcr gwh sxs bkh nxz dkf
bfx: chs bct
pjk: bkk sxh qmc zbw kdt pdr wrc
mgc: bcb scc jzc nqk ppd qhm
tbc: pbh hmw txg
rpf: hzb rzg bbr wmq jnj wxf vjr
xst: vmf lkx nxs pdf kqz fmn
nmw: srb fkv hvz ptq dff fns
chc: sqk mrl
rrv: cnp lzv ttv kxk znt
njx: bpl crp pkn tnh ztv rjg wnc btr lxs
zxg: gdw
zwx: xcw fkz
dzz: hzh rbc ksb skf zhk
jrj: ddp jng
rfr: xhm
smg: jnj llv rmm gbb bff qrl vpz sjl zpp
qtj: gjk znw pxw
stq: kkl txz dwz mtj fbc wrp
mfg: mcx xrm kdw
rwk: ckt bwm szt cnk xjw znd
mbr: dmj wtm
sdl: kpb vzb ltk cxn cwq css njr
qcg: vcq npx szf xbm brn shh jpk
jkt: gfv fzc
hxw: fwg
njr: jfx sdl
chw: cwl hgw qjp mkp
zpv: btq
vzb: qbg pnr
mgn: btx sgs
bgd: bmd zzr svs
xnz: rld mbx rdr fmm lxx
plv: xdr xgd xrm rxq
wvz: lmr
ddp: wsj qvx bcn
tkq: zkv hbz bcv sll
wnc: hlk dwd gzv bwm wfz
smz: fmx plj btx scc gqq fch
dfl: nbl rhl lkz fsf jlp skv nrq
cjk: hkw bkz
bdk: sgt znl xtk jkh
dcs: lxr
czd: pzw cxn fvs dzc
qlb: rhx mnn ntm frh wtt qhj
nqh: tkx kbj crh
zgf: wpk skv tzl flb gkx
ljm: nks qtj bdc
jzv: wcn
mzv: zpx cwc kgh sww vfg
mbx: tbm sds
shm: phj nws szz xlf hnr
lbz: wwb kcb nln jpk jrd
pqw: kmb wvz bvv bnk wsg tqc nlz lnm
zhr: xwq cdl wcn
rcn: znr hzn
hpw: lgq mcs tbp lrr tbq fpg dtf gjg
bnp: pbh cxq qpv kqg dqx pgj
sfq: ztk gbh pwg wbv dxb fdf
swk: lqz gtb
vnv: dzz qlw zmd kjk
fbc: stq qkm lnk qsw
rcb: hdx whl
slb: bkz bbr jhh lkq
cxb: hcp flg wlt gtz
hhd: jrd rrh pwf jtg kxd dvr
mhm: ngf nvr vsj fjk mmn
xld: jzf
ncp: gdf ppd gkf jtg
dcr: bvd xnr crd kfj wrp lzw
ghc: hgl bcx
vwb: qjz bjn gkf fbr jsf
lpj: hmz tfs zvg ckt bck
nwr: hzn psq dtn rjs qlw mrn fqm
zzt: ccc tnz rrh nbj szz
ngq: kcj hlk
wfb: xpg nqk ttt cmd bnr tzl qfj
zcv: qlx wlj qsg kdt
dtp: nxz mqj ckv pjf hmx pbh
czq: bzr fzc xqz mbn czz
wlj: rzw qvd mcl
wxx: hmf wbp mkp xcw
mrn: spl zln wgw nwr
jfs: dnx bdz
wlp: nrg rjs btp zdh
dxw: ntl mlj qvx mfb xff ldn
swq: xtf qgb xgn
ckt: sgb lpj lbx pjf brj
hbr: mcn xgl dxk crl whl kvz ttm ntl kmr
nfc: pzd nbq
lgr: fxq jqd jmv hmx djq nrg
kdx: zqn vsk vcr mvx
rxv: hfm xrd rsc btg
xcw: sgs wxp qgj zwx kbn qlv vdk wxx
mkz: bpl sjw ngf
zmg: hpq lnm qln rds sbp xcq lcd tkx brk
nql: bdm rzf bgf hdx wlv dfn qhf zrs fvs
sgn: nqq bnb vbf
cnb: bwm ggt jrc xjw qbf
xpg: njp wfb nxq fnm vcm wcp lqz
phj: pdx tcz pqt shm
qrn: rrx hfb vdm kph ptb
zqr: vwh zbb vjj cbn sjc nkr
wtk: wmq jkt
gfv: mzm dcc jkt wqs ngz pvm ffz mfb
bsw: zbq gdf rrm
lxl: mcm tqm frs vlj btl jrg wrv nwd
qqk: rsq zbz rbj pgh bpl
mhq: mbn wsj
dxk: lqz hbr
sxr: khj vcr fwg
pqx: hzc rhr vbq
nfv: lsd mkj qnv hnj xgl fgn zpp
dqj: skj nwr lwl crp xhm rjf pkn qws fjf xnf
ddz: mnq whv pzd gkm nqf
cxn: sdl rzf czd lbv
jlx: vqv fvr fnm lcd
bdz: xhc jfs lhx
fsk: zsp jfw
vlt: jpj zbg kcs msb tvp qdk
bzr: vqn cwq dvj cwc zbq mmt czq mqz lhw
wmq: wtk srb wxz
fsg: hpq ttm cjk
fbd: ttl xsm
rhr: dtk sxr lrj qmc kcf fpt pch vwt pqx
fqz: hld hpq hgc kbn cch gzp fqv cvx dbg srm
brj: pjg rmf ckt gwh xcs tjs
hwl: vnc pxk
gjg: nhv rsq fqm hpw jxg
gmb: bgm hmf wpf drg
xxn: wmv blr krp zbt
jfq: sfr rfb mgc
lzw: kfj tdz qws pfw dcr nxv pnt flt
sbm: pdx npm rdh rcp
lzb: dhx
cvv: snq lbv nxq dss
nrm: dgz mnq hkk
fgx: rql mwl mfg nww xxp jkh rvt skl
zbt: zrs mgn
pxw: dld kcj dmb kxl zzr fsj pgh bkk mmz sbl qtj
xfd: mtj
mcm: lxl hhk cnp hmx rjs
jfl: rmj dzh xlm xkh
nqr: cth zlc kcs tbc vnp
hrl: zjx dmb gdq nbp xfr
pkn: zln tsx njx kcc qzw
flb: gpm zgf wcx kvz hdb
nsb: jrq cdl wtv ggt
gjc: sbl bmd trh vsj wrc dmz csn
drc: whp drg rcl rld bmv phn
ppx: xft stt lcs qrc gjk
jbk: qff lqd jjh ktb ckv psj vsk qnw
xqz: hqh fpf czq
rqr: fkz tdb jlp bdm tkx vqb bsw szx
dvr: kbc nvl
jfw: fsk knr
kkn: tbp zrb
vqq: szz wcl blr qnt mbg
lfj: xlw mkj zrs pcm fzc
mnn: cdm dnx rql nfk bsw sjx chw qlb
kmw: bnp xnw sxs sjg wtn wlt bbs zjx crv bzz
wsj: mhq cqh
qpz: bxh kxk rzh sjw nxz zql lcs vmn
dmz: bqx pdf cqk pzn fmn gcw vjj
sbl: gvf crz
kxl: mtk rjx
wlm: zzt wcl xpc wrl ffl rdn qgw
nsx: nqp qjl rzw ptp
xgn: gtf xdj swq
znd: rwk znw rsl tlq cpt qrc
zvs: fhr stf
rrh: ljs hhd
swl: btx nzz wrl cdv
ltk: ffl csd
gwp: rvs jzv htf qzw
clp: wxf mkg mtm qbg clb xgd
gww: mlq kkn xcx gfp xfs wql krl jfj
vst: pxj kcx
qwj: mpw qjz cwl
jdq: rdl xwk xtx
wcr: mgh gfg gmm gfc rcf hdc fgn
khv: dnm sxh cdn
jtl: qxl vwb vrm xmx qnt
nzz: szx rzk swl nbj
ckz: bmw mhq fcv fbv
ntl: hbr dmn
dmn: qhj ntl crq lsd cmm
qff: jbk ksw wdx vlj
vvx: bvv whl
cqp: vmn chc dmj
qzw: kqz
nzq: jdz qbb tbp
wtt: qlb vkv qjp
ssr: jxz ppd njs dcc mzg znv zpp zjw
szf: hkw mjh
cdl: krj fbn
gpk: hnl nqk
dlm: qrl mnk cbz whp hhm mgc wkx
hpl: jld nmh pnl flr gfc rcp ptb vnc zhl zkk
zdd: kph tdl xgd ddp shh vbp pnl wdb
vdd: kdw fjp xpc gfv fmm
lrj: wfz frs rhr djl
scd: gjd vwt pbh pwg zfz
dkf: gmp lmh bct
zvp: hqh qjz dvj ckz svm
cnh: vkf qcm kgf zqn jbz xnf
dvz: qjz rwf swk
jdd: xnr bvr btl fpt zfz
vtr: qbf cwf mwd xnw hmg bzz gfp gmw cvk
fsf: mmt dtj xtk
zjx: hrl tdn hlk lrj psj bqx
bqq: qww xkv gjk
prb: hnj qbp mlf chd jlx jfx ssp
ddv: dsv dbp gdc mrn lkp lxs
zqq: khc qbp kxr pwd pwt czd
xjj: jrg tbc bxh
bff: pwf bbz rdr wng dzs ksg jgw
rgm: psq pfh szw
lkg: shl hbz zxf
fqm: pdf qzw
nnc: sdk jjh gng vfr bnc sdm bsq lmh qkc wst
ckn: rmq znw hbb qgz zwz fdf fdp rcs spl
wsg: rfb xgl jfk lwn pqw tzc tkx
wmx: fpg nwd wnc lcm
jsf: lbf kbj rjk vwb wgq
phs: bdt qxx
nkc: zbq vqs xtx
wcx: msh mbn zbl
nlz: czz btq
cvx: fqz qxx bmn brn rbz ngp
mvq: qrw krj bsp lht
wht: dcc tzl
ksw: xsm cfj qff fml rzv dqm
xmf: gbm jqk hqh
jgw: wxx bff gpg ptq
pcm: drz vld lgt
nxv: wpw lzw sdr lzc nbp ncq
svk: dbr tbm rnc rzg gfg bqt fbp pqt
crl: fwh rdn nlf pcm vvx
rvs: jmv gzv clg hmw gwp
vkp: qsw sjw kxk
xxp: bkw tph vfg jlp gvz
kjt: txp hgl pfs hxw wql
xbt: zjv bct gjg qgz
jjh: jbk
hnl: hdx gpk tdm pvm njr
bzz: kmw krj rfg xbx
kdp: hds kpq dqn
rkb: fjp cmd lsf rcl gbb hgc tcz ntl lvg dlj lcd jlm qcg
lrx: wvx bmd wcc dqn qkm kjb cdl
jfk: ntm rmj cjk
bkf: cdn pgv hqd
zkq: rzv stl xgn hqd rkt jrq
nkr: gll xcm
xbc: ccc srm dnh cww
krj: psq mvq
zdh: ljv wlp bgr bfx
bjk: bfv dnh lml zsd zrs gsf
wdb: nnd qgw xkm
fsc: dnm bjl vmf cnx
gjj: qgz qcb cfj nxs
zpx: lrc kbc zrs sll mzv zkt rdr
psq: rgm rtw nwr krj
cth: lht pbw tzb lbx nqr ngf
mmf: mwl gpg zcc lqz
xrd: pbj gjk hjh ssb
nrg: qnw dmb
rzv: pml rqm nbd crp vzk zkq
zfw: rfr cfb kcs cvk jqd trd ppn
hjp: bpl wtm
mbn: wcx cdv mhq
jtb: trd
zvd: kld kdw mwf hgz hrn nkp
jzj: hfm cqx mcs npn vnq
ddx: trh vkf ztw flg mmz nbd hdj zzj
xqb: vnp gpc
wtm: hjp mcs mbr sgg snp
frj: pjg zlc lwl
kbn: xcw fqz tfk pnr
mpw: rrm skv qwj kxq
bdt: phs hqh fff fzc
nbl: bnr dfl hfz fbv wht xls hld
rjx: knh kxl
rxm: lfx skj lwt dwz cxq pch
ggt: nsb dqx qff cnb
hzb: xwk btx znv
gtb: bqk qcv lcb
ttk: vlj rmf wlt
tcz: lzb phj rkb wzz lcd
bmd: gjc bgd lrx ssb
fgn: sqm jds
rwf: njr djk gpm lxh dvz
ssj: glf hqr lmc
qbb: sxh sbz cnx jbh nzq lzc zbw
bgr: zdh
wsc: vnb wxp chf jlm jvz
kwn: srr dqm jdz ggc dqx zsl wtj cnk ptt tqm
wgw: plc zbz fzv qsd
jdz: kwn wrc nzq zcs
xdr: jlp plv jwr wgq fcv
dvt: cmm qhf
cqx: crr dcr flg
rtw: psq cdn
qrw: fsj lkp kdt mvq fsk
jwr: hft bkw vdm xdr fzj clp
znt: hgx bnc pdf msm snp rrv
tjs: npn qmd pbj bkh qgg
dnx: xbj wlc xmh jfs hdb ttm cww
ngf: mhm knh dmb flt cth shn txg mkz
ltq: wgc xfd fpg
